嗚呼	ああ
相	あい
相変わらず	あいかわらず
愛想	あいそ
相対	あいたい
間柄	あいだがら
愛憎	あいにく
合間	あいま
曖昧	あいまい
敢えて	あえて
仰ぐ	あおぐ
垢	あか
亜科	あか
銅	あかがね
証	あかし
赤字	あかじ
明かす	あかす
赤ちゃん	あかちゃん
明白	あからさま
赤らむ	あからむ
明るい	あかるい
上がり	あがり
上がる	あがる
商人	あきうど
空間	あきま
諦め	あきらめ
呆れる	あきれる
悪	あく
灰	あく
	あくどい
悪日	あくび
明くる	あくる
憧れ	あこがれ
顎	あご
麻	あさ
明後日	あさって
朝寝坊	あさねぼう
浅ましい	あさましい
字	あざ
欺く	あざむく
鮮やか	あざやか
あざ笑う	あざわらう
味わい	あじわい
東	あずま
焦る	あせる
彼処	あそこ
値	あたい
値する	あたいする
私	あたし
当たり	あたり
当たり前	あたりまえ
他人	あだびと
彼方此方	あちこち
彼方	あちら
彼方此方	あちらこちら
悪化	あっか
呆気ない	あっけない
悪口	あっこう
	あっさり
圧迫	あっぱく
扱い	あつかい
集まる	あつまる
誂える	あつらえる
圧力	あつりょく
当て	あて
宛	あて
当て字	あてじ
当てはまる	あてはまる
当てはめる	あてはめる
宛てる	あてる
跡継ぎ	あとつぎ
後回し	あとまわし
貴女	あなた
彼の	あの
溢れる	あふれる
油絵	あぶらえ
炙る	あぶる
	あべこべ
甘える	あまえる
甘口	あまくち
雨具	あまぐ
天	あまつ
網	あみ
天地	あめつち
操る	あやつる
	あやふや
危ぶむ	あやぶむ
過ち	あやまち
誤る	あやまる
歩み	あゆみ
歩む	あゆむ
	あら
予め	あらかじめ
荒らす	あらす
粗筋	あらすじ
争い	あらそい
改まる	あらたまる
荒っぽい	あらっぽい
凡ゆる	あらゆる
	あられ
現われ	あらわれ
現われる	あらわれる
有難う	ありがとう
有様	ありさま
有りのまま	ありのまま
或る	ある
或いは	あるいは
彼此	あれこれ
合わす	あわす
合わせ	あわせ
慌ただしい	あわただしい
慌てる	あわてる
暗殺	あんさつ
暗算	あんざん
暗示	あんじ
案じる	あんじる
安静	あんせい
案の定	あんのじょう
余り	あんまり
依	い
良い	いい
伊井	いい
否	いいえ
いい加減	いいかげん
言い訳	いいわけ
家出	いえで
家主	いえぬし
如何	いかが
生かす	いかす
雷	いかずち
如何に	いかに
如何にも	いかにも
怒り	いかり
怒る	いかる
歪む	いがむ
粋	いき
域外	いきがい
意気込む	いきごむ
経緯	いきさつ
行き違い	いきちがい
行き成り	いきなり
異議	いぎ
	いく
軍	いくさ
戦	いくさ
育成	いくせい
幾多	いくた
活ける	いける
異見	いけん
意向	いこう
移行	いこう
	いざ
碑	いしぶみ
衣装	いしょう
意地	いじ
苛める	いじめる
移住	いじゅう
弄る	いじる
何れ	いずれ
異性	いせい
遺跡	いせき
依然	いぜん
依存	いそん
委託	いたく
悪戯	いたずら
頂	いただき
戴きます	いただきます
至って	いたって
痛む	いたむ
痛める	いためる
炒める	いためる
労る	いたわる
市	いち
位地	いち
一々	いちいち
一概に	いちがいに
一見	いちげん
一言	いちげん
一日	いちじつ
一定	いちじょう
著しい	いちじるしい
一同	いちどう
一人	いちにん
一部	いちぶ
一部分	いちぶぶん
一別	いちべつ
一面	いちめん
一目	いちもく
一様	いちよう
一律	いちりつ
一連	いちれん
一括	いっかつ
一気	いっき
一挙に	いっきょに
一切	いっさい
一心	いっしん
	いっそ
一帯	いったい
一敗	いっぱい
一変	いっぺん
何時	いつ
何時か	いつか
何時でも	いつでも
何時の間にか	いつのまにか
何時までも	いつまでも
何時も	いつも
意図	いと
営む	いとなむ
暇	いとま
異動	いどう
挑む	いどむ
稲光	いなびかり
古	いにしえ
祈り	いのり
鼾	いびき
今更	いまさら
未だ	いまだ
移民	いみん
厭々	いやいや
卑しい	いやしい
	いやに
厭やらしい	いやらしい
愈々	いよいよ
意欲	いよく
苛々	いらいら
入口	いりくち
衣料	いりょう
威力	いりょく
入る	いる
衣類	いるい
色々	いろいろ
異論	いろん
所謂	いわゆる
印	いん
員	いん
印鑑	いんかん
陰気	いんき
隠居	いんきょ
上下	うえした
浮かぶ	うかぶ
受かる	うかる
含嗽	うがい
受け入れ	うけいれ
受け入れる	うけいれる
受け継ぐ	うけつぐ
受け付ける	うけつける
受け止める	うけとめる
受け取り	うけとり
受身	うけみ
動き	うごき
潮	うしお
氏	うじ
渦	うず
埋まる	うずまる
嘘つき	うそつき
打ち合わせ	うちあわせ
打ち合わせる	うちあわせる
打ち切る	うちきる
打ち消し	うちけし
打ち込む	うちこむ
団扇	うちわ
内訳	うちわけ
訴え	うったえ
鬱陶しい	うっとうしい
写し	うつし
空ろ	うつろ
器	うつわ
雨天	うてん
腕前	うでまえ
饂飩	うどん
促す	うながす
唸る	うなる
自惚れ	うぬぼれ
甘い	うまい
生まれつき	うまれつき
海路	うみじ
産む	うむ
埋め込む	うめこむ
梅干	うめぼし
末	うら
裏返し	うらがえし
売り出し	うりだし
売り出す	うりだす
潤う	うるおう
五月蝿い	うるさい
売れ行き	うれゆき
浮気	うわき
上手	うわて
上回る	うわまわる
植わる	うわる
運営	うんえい
	うんざり
運送	うんそう
運賃	うんちん
云々	うんぬん
運搬	うんぱん
運命	うんめい
運輸	うんゆ
運用	うんよう
会	え
重	え
	えい
映写	えいしゃ
英字	えいじ
衛生	えいせい
映像	えいぞう
英雄	えいゆう
液	えき
役	えき
閲覧	えつらん
獲物	えもの
襟	えり
縁	えん
塩	えん
艶	えん
園	えん
円滑	えんかつ
縁側	えんがわ
沿岸	えんがん
婉曲	えんきょく
演習	えんしゅう
演出	えんしゅつ
演じる	えんじる
演ずる	えんずる
沿線	えんせん
縁談	えんだん
遠方	えんぽう
円満	えんまん
尾	お
於	お
甥	おい
追い込む	おいこむ
美味しい	おいしい
追い出す	おいだす
於いて	おいて
お出でになる	おいでになる
老いる	おいる
負う	おう
応急	おうきゅう
黄金	おうごん
黄色	おうしょく
応募	おうぼ
	おおい
大方	おおかた
大柄	おおがら
大げさ	おおげさ
大事	おおごと
大ざっぱ	おおざっぱ
大筋	おおすじ
大空	おおぞら
大幅	おおはば
大水	おおみず
公	おおやけ
お蔭	おかげ
お蔭様で	おかげさまで
可笑しい	おかしい
犯す	おかす
侵す	おかす
お菜	おかず
臆病	おくびょう
遅らす	おくらす
遅れ	おくれ
起こす	おこす
行い	おこない
厳か	おごそか
傲る	おごる
長	おさ
押さえる	おさえる
お先に	おさきに
収まる	おさまる
納まる	おさまる
治まる	おさまる
お産	おさん
教え	おしえ
押し込む	おしこむ
惜しむ	おしむ
お喋り	おしゃべり
お洒落	おしゃれ
押し寄せる	おしよせる
お祖父さん	おじいさん
お邪魔します	おじゃまします
雄	おす
お世辞	おせじ
襲う	おそう
遅くとも	おそくとも
恐らく	おそらく
恐れ	おそれ
恐れ入る	おそれいる
お大事に	おだいじに
煽てる	おだてる
落ち込む	おちこむ
落ち着き	おちつき
落ち葉	おちば
落ちる	おちる
	おっかない
仰っしゃる	おっしゃる
乙	おつ
お使い	おつかい
お手上げ	おてあげ
御手洗い	おてあらい
弟	おと
落とす	おとす
訪れる	おとずれる
大人しい	おとなしい
少女	おとめ
お供	おとも
衰える	おとろえる
	おどおど
脅かす	おどかす
脅す	おどす
驚き	おどろき
同い年	おないどし
女子	おなご
お願いします	おねがいします
各	おのおの
自ずから	おのずから
お早う	おはよう
お祖母さん	おばあさん
怯える	おびえる
夥しい	おびただしい
帯びる	おびる
覚え	おぼえ
御負け	おまけ
お巡りさん	おまわりさん
お宮	おみや
お襁褓	おむつ
お目出度う	おめでとう
面	おも
思い付き	おもいつき
面白い	おもしろい
玩具	おもちゃ
重なる	おもなる
趣	おもむき
赴く	おもむく
重役	おもやく
重んじる	おもんじる
重んずる	おもんずる
お休み	おやすみ
お八	おやつ
凡そ	およそ
及び	および
及ぶ	およぶ
織	おり
檻	おり
折り返す	おりかえす
織物	おりもの
織る	おる
俺	おれ
愚か	おろか
疎か	おろそか
終わる	おわる
音色	おんいろ
温和	おんわ
仮	か
科	か
個	か
下位	かい
階	かい
改悪	かいあく
海運	かいうん
改革	かいかく
貝殻	かいがら
階級	かいきゅう
海峡	かいきょう
会見	かいけん
介護	かいご
開催	かいさい
回収	かいしゅう
改修	かいしゅう
怪獣	かいじゅう
解除	かいじょ
回送	かいそう
階層	かいそう
開拓	かいたく
会談	かいだん
改定	かいてい
改訂	かいてい
街道	かいどう
介入	かいにゅう
開発	かいはつ
海抜	かいばつ
介抱	かいほう
解剖	かいぼう
回覧	かいらん
海流	かいりゅう
改良	かいりょう
回路	かいろ
顧みる	かえりみる
省みる	かえりみる
返る	かえる
顔付き	かおつき
掲げる	かかげる
踵	かかと
係り	かかり
課外	かがい
書き取り	かきとり
書き取る	かきとる
掻き回す	かきまわす
欠く	かく
角	かく
核	かく
格	かく
佳句	かく
画	かく
格差	かくさ
拡散	かくさん
各種	かくしゅ
隔週	かくしゅう
確信	かくしん
革新	かくしん
確定	かくてい
獲得	かくとく
確保	かくほ
革命	かくめい
確立	かくりつ
賭け	かけ
掛け	かけ
駆け足	かけあし
家計	かけい
駆けっこ	かけっこ
駆ける	かける
賭ける	かける
ヶ月	かげつ
加工	かこう
化合	かごう
嵩張る	かさばる
嵩む	かさむ
風車	かざぐるま
畏まりました	かしこまりました
華奢	かしゃ
箇所	かしょ
火傷	かしょう
箇条書き	かじょうがき
噛る	かじる
微か	かすか
霞む	かすむ
化する	かする
擦る	かする
火星	かせい
化石	かせき
河川	かせん
化繊	かせん
過疎	かそ
過多	かた
難い	かたい
片思い	かたおもい
敵	かたき
気質	かたぎ
片言	かたこと
片付け	かたづけ
傾く	かたぶく
傾ける	かたむける
固める	かためる
偏る	かたよる
傍ら	かたわら
課題	かだい
花壇	かだん
家畜	かちく
画期	かっき
活発	かっぱつ
且つ	かつ
割	かつ
嘗て	かつて
日付	かづけ
門	かど
叶う	かなう
叶える	かなえる
金槌	かなづち
鉄棒	かなぼう
可成	かなり
加入	かにゅう
金庫	かねぐら
予言	かねごと
兼ねて	かねて
下番	かばん
下品	かひん
華美	かび
花粉	かふん
株式	かぶしき
気触れる	かぶれる
貨幣	かへい
構え	かまえ
構える	かまえる
加味	かみ
噛み切る	かみきる
過密	かみつ
瓶	かめ
かも知れない	かもしれない
粥	かゆ
痒い	かゆい
揶揄う	からかう
身体	からだ
体付き	からだつき
絡む	からむ
借り	かり
下吏	かり
加留多	かるた
涸れる	かれる
過労	かろう
辛うじて	かろうじて
側	かわ
可愛い	かわいい
可愛がる	かわいがる
可哀想	かわいそう
可愛らしい	かわいらしい
交わす	かわす
代わる	かわる
代わる代わる	かわるがわる
乾	かん
管	かん
幹	かん
冠	かん
観	かん
館	かん
簡易	かんい
感慨	かんがい
寒気	かんき
簡潔	かんけつ
還元	かんげん
刊行	かんこう
慣行	かんこう
勧告	かんこく
看護	かんご
漢語	かんご
換算	かんさん
監視	かんし
慣習	かんしゅう
観衆	かんしゅう
干渉	かんしょう
感触	かんしょく
肝心	かんじん
歓声	かんせい
感染	かんせん
幹線	かんせん
関税	かんぜい
簡素	かんそ
観点	かんてん
感度	かんど
幹部	かんぶ
勘弁	かんべん
完璧	かんぺき
感無量	かんむりょう
勧誘	かんゆう
関与	かんよ
慣用	かんよう
寛容	かんよう
観覧	かんらん
官僚	かんりょう
慣例	かんれい
還暦	かんれき
貫禄	かんろく
緩和	かんわ
蓋	がい
街	がい
外貨	がいか
外観	がいかん
外相	がいしょう
害する	がいする
概説	がいせつ
該当	がいとう
街頭	がいとう
概念	がいねん
外来	がいらい
概略	がいりゃく
学芸	がくげい
学士	がくし
学説	がくせつ
楽譜	がくふ
学歴	がくれき
崖	がけ
雅致	がち
	がっくり
合唱	がっしょう
	がっしり
合致	がっち
	がっちり
月日	がっぴ
合併	がっぺい
	がる
側	がわ
癌	がん
眼科	がんか
眼球	がんきゅう
眼鏡	がんきょう
頑固	がんこ
願書	がんしょ
頑丈	がんじょう
岩石	がんせき
元年	がんねん
贋物	がんぶつ
元来	がんらい
生	き
期	き
企画	きかく
規格	きかく
着飾る	きかざる
器官	きかん
季刊	きかん
危害	きがい
気兼ね	きがね
気軽	きがる
危機	きき
聞き取り	ききとり
効き目	ききめ
帰京	ききょう
基金	ききん
棄権	きけん
喜劇	きげき
起源	きげん
機構	きこう
既婚	きこん
記載	きさい
気障	きざ
兆し	きざし
兆	きざし
軋む	きしむ
気象	きしょう
期日	きじつ
記述	きじゅつ
奇数	きすう
築く	きずく
傷付く	きずつく
規制	きせい
汽船	きせん
寄贈	きそう
貴族	きぞく
鍛える	きたえる
来る	きたる
気立て	きだて
	きちっと
几帳面	きちょうめん
切っ掛け	きっかけ
	きっかり
喫茶	きっさ
	きっちり
屹度	きっと
	きっぱり
規定	きてい
起点	きてん
軌道	きどう
甲	きのえ
気配	きはい
規範	きはん
気品	きひん
気風	きふう
起伏	きふく
規模	きぼ
気まぐれ	きまぐれ
生真面目	きまじめ
期末	きまつ
決まり悪い	きまりわるい
決まる	きまる
記名	きめい
脚色	きゃくしょく
脚本	きゃくほん
客観	きゃっかん
規約	きやく
救援	きゅうえん
休学	きゅうがく
究極	きゅうきょく
窮屈	きゅうくつ
球根	きゅうこん
救済	きゅうさい
給食	きゅうしょく
給仕	きゅうじ
休戦	きゅうせん
旧知	きゅうち
宮殿	きゅうでん
窮乏	きゅうぼう
丘陵	きゅうりょう
共	きょう
供	きょう
驚異	きょうい
教員	きょういん
教科	きょうか
協会	きょうかい
共感	きょうかん
共学	きょうがく
協議	きょうぎ
教訓	きょうくん
境遇	きょうぐう
強行	きょうこう
強硬	きょうこう
凶作	きょうさく
共産	きょうさん
教材	きょうざい
教習	きょうしゅう
郷愁	きょうしゅう
教職	きょうしょく
享受	きょうじゅ
興じる	きょうじる
強制	きょうせい
共存	きょうそん
姉妹	きょうだい
協調	きょうちょう
協定	きょうてい
脅迫	きょうはく
共鳴	きょうめい
郷里	きょうり
強烈	きょうれつ
共和	きょうわ
曲	きょく
局限	きょくげん
極端	きょくたん
居住	きょじゅう
拒絶	きょぜつ
拒否	きょひ
許容	きょよう
距離	きょり
寄与	きよ
清らか	きよらか
気楽	きらく
煌びやか	きらびやか
切り	きり
桐	きり
切り替える	きりかえる
気流	きりゅう
奇麗	きれい
切れ目	きれめ
際	きわ
木綿	きわた
極めて	きわめて
僅	きん
近眼	きんがん
緊急	きんきゅう
近々	きんきん
近郊	きんこう
均衡	きんこう
近視	きんし
禁じる	きんじる
禁ずる	きんずる
勤勉	きんべん
勤務	きんむ
禁物	きんもつ
勤労	きんろう
議案	ぎあん
戯曲	ぎきょく
議決	ぎけつ
議事堂	ぎじどう
犠牲	ぎせい
偽造	ぎぞう
議題	ぎだい
技能	ぎのう
逆転	ぎゃくてん
行	ぎょう
業者	ぎょうしゃ
行政	ぎょうせい
業績	ぎょうせき
業務	ぎょうむ
玉	ぎょく
漁船	ぎょせん
漁村	ぎょそん
義理	ぎり
疑惑	ぎわく
吟味	ぎんみ
区	く
食い違う	くいちがう
空腹	くうふく
区画	くかく
区間	くかん
茎	くき
区切り	くぎり
潜る	くぐる
種々	くさぐさ
嚏	くしゃみ
旧事	くじ
籤引	くじびき
擽ぐったい	くすぐったい
草臥れる	くたびれる
下らない	くだらない
件	くだん
口ずさむ	くちずさむ
嘴	くちばし
朽ちる	くちる
	くっきり
屈折	くっせつ
くっ付く	くっつく
くっ付ける	くっつける
覆す	くつがえす
諄い	くどい
国境	くにざかい
首飾り	くびかざり
首輪	くびわ
組み合わせ	くみあわせ
組み合わせる	くみあわせる
組み込む	くみこむ
蔵	くら
苦しめる	くるしめる
包む	くるむ
呉れ呉れも	くれぐれも
呉れる	くれる
玄人	くろうと
黒字	くろじ
君主	くんしゅ
愚痴	ぐち
	ぐっと
	ぐらい
群	ぐん
軍艦	ぐんかん
群集	ぐんしゅう
軍事	ぐんじ
軍備	ぐんび
軍服	ぐんぷく
刑	けい
頃	けい
傾	けい
系	けい
経過	けいか
軽快	けいかい
警戒	けいかい
計器	けいき
契機	けいき
敬具	けいぐ
軽減	けいげん
掲載	けいさい
傾斜	けいしゃ
形成	けいせい
形勢	けいせい
軽率	けいそつ
携帯	けいたい
形態	けいたい
刑罰	けいばつ
経費	けいひ
警部	けいぶ
軽蔑	けいべつ
経歴	けいれき
経路	けいろ
汚す	けがす
汚らわしい	けがらわしい
汚れ	けがれ
汚れる	けがれる
獣	けだもの
吝嗇	けち
結核	けっかく
血管	けっかん
決行	けっこう
決算	けっさん
決勝	けっしょう
結晶	けっしょう
結成	けっせい
結束	けっそく
傑	けつ
決意	けつい
決議	けつぎ
結合	けつごう
決断	けつだん
欠乏	けつぼう
蹴飛ばす	けとばす
貶す	けなす
煙たい	けむたい
煙る	けむる
家来	けらい
	けれど
圏	けん
権	けん
権威	けんい
兼業	けんぎょう
権限	けんげん
健在	けんざい
懸賞	けんしょう
検事	けんじ
健全	けんぜん
見地	けんち
賢明	けんめい
倹約	けんやく
兼用	けんよう
権力	けんりょく
劇団	げきだん
激励	げきれい
月謝	げっしゃ
	げっそり
月賦	げっぷ
下痢	げり
原	げん
原形	げんけい
現行	げんこう
原作	げんさく
原子	げんし
元首	げんしゅ
原書	げんしょ
減少	げんしょう
現場	げんじょう
元素	げんそ
原則	げんそく
現像	げんぞう
現地	げんち
限定	げんてい
原点	げんてん
原典	げんてん
減点	げんてん
原爆	げんばく
原文	げんぶん
厳密	げんみつ
原油	げんゆ
言論	げんろん
故	こ
戸	こ
児	こ
巨	こ
恋する	こいする
溝	こう
校	こう
好意	こうい
行為	こうい
行員	こういん
交易	こうえき
公演	こうえん
後悔	こうかい
公開	こうかい
航海	こうかい
工学	こうがく
皇居	こうきょ
好況	こうきょう
抗議	こうぎ
鉱業	こうぎょう
興業	こうぎょう
高原	こうげん
煌々と	こうこうと
考古学	こうこがく
交互	こうご
工作	こうさく
耕作	こうさく
鉱山	こうざん
講習	こうしゅう
交渉	こうしょう
高尚	こうしょう
行進	こうしん
香辛料	こうしんりょう
口述	こうじゅつ
控除	こうじょ
向上	こうじょう
降水	こうすい
洪水	こうずい
公然	こうぜん
抗争	こうそう
構想	こうそう
拘束	こうそく
後退	こうたい
光沢	こうたく
公団	こうだん
好調	こうちょう
口頭	こうとう
講読	こうどく
購読	こうどく
購入	こうにゅう
公認	こうにん
光熱費	こうねつひ
荒廃	こうはい
購買	こうばい
好評	こうひょう
交付	こうふ
降伏	こうふく
興奮	こうふん
公募	こうぼ
巧妙	こうみょう
公用	こうよう
小売	こうり
効率	こうりつ
公立	こうりつ
小柄	こがら
小切手	こぎって
国産	こくさん
国定	こくてい
国土	こくど
告白	こくはく
国防	こくぼう
国有	こくゆう
国連	こくれん
漕ぐ	こぐ
焦げ茶	こげちゃ
個々	ここ
箇箇	ここ
心地	ここち
心得	こころえ
心掛け	こころがけ
心掛ける	こころがける
志	こころざし
志す	こころざす
心強い	こころづよい
心細い	こころぼそい
試み	こころみ
試みる	こころみる
快い	こころよい
凝らす	こごらす
凝る	こごる
拵える	こしらえる
孤児	こじ
拗れる	こじれる
故人	こじん
梢	こずえ
個性	こせい
戸籍	こせき
小銭	こぜに
固体	こたい
答え	こたえ
堪える	こたえる
火燵	こたつ
古代	こだい
	こだわる
誇張	こちょう
滑稽	こっけい
国交	こっこう
骨董品	こっとうひん
骨	こつ
固定	こてい
事柄	ことがら
悉く	ことごとく
言伝	ことづて
殊に	ことに
事によると	ことによると
孤独	こどく
粉々	こなごな
此の	この
この間	このあいだ
この頃	このごろ
好ましい	このましい
個別	こべつ
零す	こぼす
零れる	こぼれる
細やか	こまやか
混む	こむ
込める	こめる
篭る	こもる
固有	こゆう
雇用	こよう
暦	こよみ
堪える	こらえる
孤立	こりつ
懲りる	こりる
此れ	これ
此れ等	これら
魂	こん
根気	こんき
根拠	こんきょ
混血	こんけつ
昆虫	こんちゅう
根底	こんてい
混同	こんどう
今日は	こんにちは
今晩は	こんばんは
根本	こんぽん
御	ご
語彙	ごい
濠	ごう
業	ごう
号	ごう
合意	ごうい
合議	ごうぎ
強気	ごうぎ
合成	ごうせい
護衛	ごえい
語句	ごく
極楽	ごくらく
ご苦労様	ごくろうさま
語源	ごげん
誤差	ごさ
ご座います	ございます
ご馳走	ごちそう
ご馳走さま	ごちそうさま
毎	ごと
碁盤	ごばん
ご無沙汰	ごぶさた
誤魔化す	ごまかす
御免ください	ごめんください
御免なさい	ごめんなさい
御覧なさい	ごらんなさい
佐	さ
再	さい
差異	さい
歳	さい
再会	さいかい
災害	さいがい
細菌	さいきん
細工	さいく
採掘	さいくつ
採決	さいけつ
再建	さいけん
再現	さいげん
採算	さいさん
採集	さいしゅう
再生	さいせい
最善	さいぜん
採択	さいたく
再発	さいはつ
栽培	さいばい
細胞	さいぼう
採用	さいよう
遮る	さえぎる
囀る	さえずる
冴える	さえる
竿	さお
栄える	さかえる
杯	さかずき
逆立ち	さかだち
逆上る	さかのぼる
盛る	さかる
差額	さがく
下がる	さがる
一昨昨日	さきおととい
先に	さきに
詐欺	さぎ
作	さく
策	さく
柵	さく
削減	さくげん
錯誤	さくご
作戦	さくせん
作物	さくぶつ
叫び	さけび
裂ける	さける
捧げる	ささげる
差し掛かる	さしかかる
指図	さしず
差し出す	さしだす
差し支える	さしつかえる
差し引く	さしひく
些事	さじ
授ける	さずける
嘸	さぞ
定まる	さだまる
定める	さだめる
錯覚	さっかく
早急	さっきゅう
察する	さっする
	さっと
冊	さつ
殺人	さつじん
偖	さて
悟る	さとる
真実	さな
裁く	さばく
錆び	さび
左程	さほど
様	さま
三味線	さみせん
侍	さむらい
然も	さも
作用	さよう
左様なら	さようなら
拐う	さらう
爽やか	さわやか
障る	さわる
酸	さん
	さん
酸化	さんか
山岳	さんがく
産休	さんきゅう
桟橋	さんきょう
参議院	さんぎいん
産後	さんご
産出	さんしゅつ
参照	さんしょう
参上	さんじょう
賛成	さんせい
賛美	さんび
産婦人科	さんふじんか
産物	さんぶつ
山腹	さんぷく
山脈	さんみゃく
財	ざい
財源	ざいげん
在庫	ざいこ
財政	ざいせい
座談会	ざだんかい
雑貨	ざっか
雑	ざつ
雑談	ざつだん
雑木	ざつぼく
座標	ざひょう
残金	ざんきん
残酷	ざんこく
残高	ざんだか
死	し
	し
次	し
仕上がり	しあがり
仕上げ	しあげ
仕上げる	しあげる
明々後日	しあさって
飼育	しいく
強いて	しいて
強いる	しいる
仕入れる	しいれる
	しいんと
歯科	しか
資格	しかく
視覚	しかく
仕掛け	しかけ
仕掛ける	しかける
然し	しかし
然しながら	しかしながら
而も	しかも
市街	しがい
指揮	しき
色彩	しきさい
式場	しきじょう
為来り	しきたり
頻りに	しきりに
仕切る	しきる
資金	しきん
施行	しぎょう
	しくじる
仕組み	しくみ
死刑	しけい
湿気る	しける
思考	しこう
志向	しこう
嗜好	しこう
視察	しさつ
資産	しさん
刺繍	ししゅう
支持	しじ
指示	しじ
雫	しずく
沈める	しずめる
施設	しせつ
子息	しそく
慕う	したう
従って	したがって
下心	したごころ
親しむ	したしむ
下調べ	したしらべ
下地	したじ
認める	したためる
仕立てる	したてる
下取り	したどり
下火	したび
失格	しっかく
確り	しっかり
質素	しっそ
失調	しっちょう
嫉妬	しっと
尻尾	しっぽ
室	しつ
質疑	しつぎ
躾	しつけ
仕付ける	しつける
指摘	してき
視点	してん
萎びる	しなびる
嫋か	しなやか
屎尿	しにょう
凌ぐ	しのぐ
始発	しはつ
芝	しば
屡	しばしば
暫く	しばらく
痺れる	しびれる
渋い	しぶい
私物	しぶつ
	しぶとい
司法	しほう
脂肪	しぼう
志望	しぼう
萎む	しぼむ
仕舞	しまい
仕舞う	しまう
	しまった
始末	しまつ
泌み泌み	しみじみ
染みる	しみる
使命	しめい
締め切り	しめきり
僕	しもべ
社交	しゃこう
謝絶	しゃぜつ
社宅	しゃたく
吃逆	しゃっくり
喋る	しゃべる
斜面	しゃめん
洒落	しゃらく
洒落る	しゃれる
視野	しや
種	しゅ
衆	しゅう
周	しゅう
収益	しゅうえき
修学	しゅうがく
周期	しゅうき
衆議院	しゅうぎいん
就業	しゅうぎょう
修行	しゅうぎょう
集計	しゅうけい
襲撃	しゅうげき
収支	しゅうし
終始	しゅうし
修士	しゅうし
収集	しゅうしゅう
修飾	しゅうしょく
終日	しゅうじつ
執着	しゅうじゃく
収容	しゅうよう
修了	しゅうりょう
守衛	しゅえい
主演	しゅえん
主観	しゅかん
祝賀	しゅくが
宿命	しゅくめい
主権	しゅけん
手芸	しゅげい
主催	しゅさい
取材	しゅざい
趣旨	しゅし
主食	しゅしょく
主人公	しゅじんこう
主体	しゅたい
主題	しゅだい
出血	しゅっけつ
出産	しゅっさん
出社	しゅっしゃ
出生	しゅっしょう
出世	しゅっせ
出費	しゅっぴ
出品	しゅっぴん
出演	しゅつえん
出題	しゅつだい
出動	しゅつどう
主導	しゅどう
主任	しゅにん
首脳	しゅのう
守備	しゅび
手法	しゅほう
私有	しゆう
諸	しょ
背負う	しょう
象	しょう
症	しょう
傷	しょう
商	しょう
消去	しょうきょ
衝撃	しょうげき
証言	しょうげん
証拠	しょうこ
消耗	しょうこう
照合	しょうごう
詳細	しょうさい
昇進	しょうしん
少数	しょうすう
称する	しょうする
消息	しょうそく
承諾	しょうだく
象徴	しょうちょう
小児科	しょうにか
証人	しょうにん
照明	しょうめい
勝利	しょうり
奨励	しょうれい
職員	しょくいん
植民地	しょくみんち
職務	しょくむ
諸君	しょくん
所在	しょざい
所々	しょしょ
所持	しょじ
所属	しょぞく
処置	しょち
	しょっちゅう
所定	しょてい
所得	しょとく
初版	しょはん
処罰	しょばつ
書評	しょひょう
処分	しょぶん
庶民	しょみん
庶務	しょむ
私用	しよう
仕様	しよう
使用人	しようにん
調べ	しらべ
知り合い	しりあい
退く	しりぞく
退ける	しりぞける
記す	しるす
指令	しれい
代	しろ
皺	しわ
新	しん
進化	しんか
殿	しんがり
審議	しんぎ
進行	しんこう
新興	しんこう
振興	しんこう
申告	しんこく
新婚	しんこん
審査	しんさ
紳士	しんし
進出	しんしゅつ
信者	しんじゃ
真珠	しんじゅ
心中	しんじゅう
心情	しんじょう
新人	しんじん
神聖	しんせい
親善	しんぜん
真相	しんそう
新築	しんちく
進呈	しんてい
進展	しんてん
神殿	しんでん
進度	しんど
振動	しんどう
新入生	しんにゅうせい
信任	しんにん
審判	しんばん
神秘	しんぴ
辛抱	しんぼう
真理	しんり
侵略	しんりゃく
診療	しんりょう
進路	しんろ
自覚	じかく
地方	じかた
自我	じが
磁気	じき
磁器	じき
事業	じぎょう
地形	じぎょう
軸	じく
自己	じこ
事項	じこう
時刻表	じこくひょう
地獄	じごく
時差	じさ
自在	じざい
自主	じしゅ
自首	じしゅ
辞職	じしょく
自信	じしん
事前	じぜん
自尊心	じそんしん
持続	じぞく
字体	じたい
辞退	じたい
	じっくり
実質	じっしつ
実践	じっせん
実態	じったい
実費	じっぴ
十分	じっぷん
実	じつ
実業家	じつぎょうか
実情	じつじょう
自転	じてん
自動詞	じどうし
地主	じぬし
耳鼻科	じびか
地元	じもと
弱	じゃく
若干	じゃっかん
砂利	じゃり
じゃん拳	じゃんけん
住	じゅう
従業員	じゅうぎょういん
従事	じゅうじ
充実	じゅうじつ
十字路	じゅうじろ
絨毯	じゅうたん
柔軟	じゅうなん
重複	じゅうふく
重宝	じゅうほう
従来	じゅうらい
塾	じゅく
樹木	じゅもく
樹立	じゅりつ
準急	じゅんきゅう
準じる	じゅんじる
準ずる	じゅんずる
助	じょ
情	じょう
畳	じょう
尉	じょう
嬢	じょう
状	じょう
上位	じょうい
上演	じょうえん
城下	じょうか
乗客	じょうかく
上空	じょうくう
上司	じょうし
情緒	じょうしょ
上昇	じょうしょう
情勢	じょうせい
情熱	じょうねつ
丈夫	じょうふ
譲歩	じょうほ
条約	じょうやく
上陸	じょうりく
蒸留	じょうりゅう
除外	じょがい
助言	じょげん
徐行	じょこう
女史	じょし
助詞	じょし
助動詞	じょどうし
自立	じりつ
人	じん
人格	じんかく
人材	じんざい
迅速	じんそく
人体	じんたい
人民	じんみん
人目	じんもく
水気	すいき
水源	すいげん
推進	すいしん
水洗	すいせん
吹奏	すいそう
推測	すいそく
水田	すいでん
推理	すいり
数詞	すうし
崇拝	すうはい
据え付ける	すえつける
据える	すえる
清々しい	すがすがしい
過ぎ	すぎ
救い	すくい
掬う	すくう
少なくとも	すくなくとも
直ぐ	すぐ
健やか	すこやか
濯ぐ	すすぐ
進み	すすみ
勧め	すすめ
裾	すそ
廃れる	すたれる
酸っぱい	すっぱい
素敵	すてき
即ち	すなわち
	すばしこい
素早い	すばやい
済ます	すます
澄ます	すます
済まない	すまない
済みません	すみません
天皇	すめらぎ
刷り	すり
剃る	する
擦れ違い	すれちがい
すれ違う	すれちがう
擦れる	すれる
	すんなり
図々しい	ずうずうしい
	ずばり
ずぶ濡れ	ずぶぬれ
	ずらっと
	ずるずる
	ずれ
	ずれる
制	せい
製	せい
生育	せいいく
成果	せいか
正解	せいかい
正規	せいき
正義	せいぎ
生計	せいけい
政権	せいけん
精巧	せいこう
制裁	せいさい
政策	せいさく
清算	せいさん
星座	せいざ
生死	せいし
静止	せいし
青春	せいしゅん
聖書	せいしょ
誠実	せいじつ
成熟	せいじゅく
清純	せいじゅん
正常	せいじょう
制する	せいする
整然	せいぜん
盛装	せいそう
盛大	せいだい
清濁	せいだく
制定	せいてい
静的	せいてき
製鉄	せいてつ
晴天	せいてん
正当	せいとう
成年	せいねん
制服	せいふく
征服	せいふく
製法	せいほう
精密	せいみつ
声明	せいめい
姓名	せいめい
制約	せいやく
生理	せいり
勢力	せいりょく
整列	せいれつ
急かす	せかす
伜	せがれ
責務	せきむ
世辞	せじ
世帯	せたい
世代	せだい
切開	せっかい
接触	せっしょく
設置	せっち
折衷	せっちゅう
設定	せってい
説得	せっとく
節	せつ
切実	せつじつ
接続詞	せつぞくし
切ない	せつない
設立	せつりつ
攻め	せめ
世論	せろん
仙	せん
前	せん
繊維	せんい
選挙	せんきょ
宣教	せんきょう
宣言	せんげん
先行	せんこう
選考	せんこう
戦災	せんさい
専修	せんしゅう
戦術	せんじゅつ
潜水	せんすい
先先月	せんせんげつ
先先週	せんせんしゅう
先代	せんだい
先だって	せんだって
先着	せんちゃく
先天的	せんてんてき
戦闘	せんとう
潜入	せんにゅう
船舶	せんぱく
専用	せんよう
占領	せんりょう
戦力	せんりょく
税務署	ぜいむしょ
是正	ぜせい
絶版	ぜっぱん
絶望	ぜつぼう
是非とも	ぜひとも
膳	ぜん
禅	ぜん
全快	ぜんかい
全盛	ぜんせい
前提	ぜんてい
前途	ぜんと
全滅	ぜんめつ
善良	ぜんりょう
前例	ぜんれい
僧	そう
沿う	そう
添う	そう
総	そう
相応	そうおう
総会	そうかい
創刊	そうかん
送金	そうきん
走行	そうこう
総合	そうごう
捜査	そうさ
捜索	そうさく
然うして	そうして
装飾	そうしょく
操縦	そうじゅう
創造	そうぞう
壮大	そうだい
騒動	そうどう
遭難	そうなん
相場	そうば
装備	そうび
創立	そうりつ
添える	そえる
即座に	そくざに
促進	そくしん
即する	そくする
束縛	そくばく
側面	そくめん
其処	そこ
其処で	そこで
損なう	そこなう
其処ら	そこら
素材	そざい
阻止	そし
然して	そして
訴訟	そしょう
育ち	そだち
措置	そち
其方	そちら
素っ気ない	そっけない
率直	そっちょく
外方	そっぽ
備え付ける	そなえつける
備わる	そなわる
園	その
その上	そのうえ
その内	そのうち
その為	そのため
その外	そのほか
其の儘	そのまま
聳える	そびえる
素朴	そぼく
染まる	そまる
背く	そむく
染める	そめる
逸らす	そらす
反り	そり
其れ	それ
其れから	それから
各々	それぞれ
其れで	それで
其れでは	それでは
其れでも	それでも
其れ共	それとも
其れに	それに
其れ程	それほど
其れ故	それゆえ
揃い	そろい
徐々	そろそろ
損失	そんしつ
存続	そんぞく
沿い	ぞい
像	ぞう
増強	ぞうきょう
蔵相	ぞうしょう
増進	ぞうしん
	ぞんざい
他意	たい
対応	たいおう
退化	たいか
体格	たいかく
大概	たいがい
退学	たいがく
大金	たいきん
待遇	たいぐう
対決	たいけつ
体験	たいけん
対抗	たいこう
対して	たいして
大衆	たいしゅう
対処	たいしょ
退職	たいしょく
退治	たいじ
態勢	たいせい
対談	たいだん
対等	たいとう
滞納	たいのう
対比	たいひ
大部	たいぶ
対辺	たいへん
待望	たいぼう
怠慢	たいまん
対面	たいめん
対立	たいりつ
体力	たいりょく
対話	たいわ
耐える	たえる
絶える	たえる
堪える	たえる
高	たか
高まる	たかまる
焚火	たきび
沢山	たくさん
逞しい	たくましい
巧み	たくみ
類	たぐい
丈	たけ
足し算	たしざん
多数決	たすうけつ
助け	たすけ
携わる	たずさわる
漂う	ただよう
館	たち
立方	たちかた
忽ち	たちまち
立ち寄る	たちよる
達者	たっしゃ
達成	たっせい
	たった
尊い	たっとい
貴い	たっとい
尊ぶ	たっとぶ
絶つ	たつ
盾	たて
建前	たてまえ
奉る	たてまつる
例え	たとえ
仮令	たとえ
他動詞	たどうし
辿り着く	たどりつく
辿る	たどる
掌	たなごころ
楽しむ	たのしむ
頼み	たのみ
煙草	たばこ
度々	たびたび
他方	たほう
多忙	たぼう
給う	たまう
偶に	たまに
堪らない	たまらない
溜まり	たまり
賜る	たまわる
例	ためし
躊躇う	ためらう
保つ	たもつ
容易い	たやすい
多様	たよう
弛み	たるみ
弛む	たるむ
誰	たれ
垂れる	たれる
歎	たん
反	たん
単一	たんいつ
短歌	たんか
担架	たんか
短気	たんき
探検	たんけん
短縮	たんしゅく
箪笥	たんす
炭素	たんそ
短大	たんだい
単調	たんちょう
単独	たんどく
短波	たんぱ
蛋白質	たんぱくしつ
第	だい
第一	だいいち
大胆	だいたん
台無し	だいなし
大便	だいべん
代弁	だいべん
台本	だいほん
代用	だいよう
打開	だかい
妥協	だきょう
丈	だけ
妥結	だけつ
打撃	だげき
駄作	ださく
脱出	だっしゅつ
脱する	だっする
脱退	だったい
	だぶだぶ
騙す	だます
	だらけ
怠い	だるい
壇	だん
団結	だんけつ
断言	だんげん
断然	だんぜん
段々	だんだん
旦那	だんな
断面	だんめん
弾力	だんりょく
治安	ちあん
近付く	ちかづく
違える	ちがえる
契る	ちぎる
畜産	ちくさん
畜生	ちくしょう
蓄積	ちくせき
知性	ちせい
乳	ちち
父母	ちちはは
縮まる	ちぢまる
窒息	ちっそく
些とも	ちっとも
秩序	ちつじょ
知的	ちてき
著	ちゃく
着	ちゃく
着手	ちゃくしゅ
着色	ちゃくしょく
着席	ちゃくせき
着目	ちゃくもく
着陸	ちゃくりく
着工	ちゃっこう
茶の間	ちゃのま
茶の湯	ちゃのゆ
	ちやほや
昼間	ちゅうかん
宙返り	ちゅうがえり
中継	ちゅうけい
忠告	ちゅうこく
中指	ちゅうし
中傷	ちゅうしょう
忠実	ちゅうじつ
中枢	ちゅうすう
抽選	ちゅうせん
中断	ちゅうだん
中腹	ちゅうっぱら
中毒	ちゅうどく
仲人	ちゅうにん
昼飯	ちゅうはん
中立	ちゅうりつ
中和	ちゅうわ
腸	ちょう
蝶	ちょう
超	ちょう
庁	ちょう
調印	ちょういん
聴覚	ちょうかく
長官	ちょうかん
聴講	ちょうこう
徴収	ちょうしゅう
聴診器	ちょうしんき
挑戦	ちょうせん
長大	ちょうだい
調停	ちょうてい
恰度	ちょうど
長編	ちょうへん
丁目	ちょうめ
調理	ちょうり
調和	ちょうわ
	ちょくちょく
直面	ちょくめん
著書	ちょしょ
貯蓄	ちょちく
直感	ちょっかん
一寸	ちょっと
著名	ちょめい
	ちらっと
塵取り	ちりとり
治療	ちりょう
賃金	ちんぎん
沈殿	ちんでん
沈没	ちんぼつ
沈黙	ちんもく
陳列	ちんれつ
追及	ついきゅう
追跡	ついせき
次いで	ついで
追放	ついほう
費やす	ついやす
墜落	ついらく
通	つう
痛感	つうかん
通常	つうじょう
痛切	つうせつ
杖	つえ
遣い	つかい
使い道	つかいみち
仕える	つかえる
司る	つかさどる
束の間	つかのま
付き	つき
付き合う	つきあう
月並み	つきなみ
尽きる	つきる
継ぎ目	つぎめ
吐く	つく
尽くす	つくす
作り	つくり
造り	つくり
造る	つくる
繕う	つくろう
接ぐ	つぐ
継ぐ	つぐ
付け加える	つけくわえる
告げる	つげる
辻褄	つじつま
途中	つちゅう
突っ張る	つっぱる
筒	つつ
銃	つつ
突く	つつく
慎む	つつしむ
伝言	つてごと
勤まる	つとまる
勤め先	つとめさき
努めて	つとめて
津波	つなみ
抓る	つねる
募る	つのる
唾	つば
呟く	つぶやく
瞑る	つぶる
壷	つぼ
蕾	つぼみ
躓く	つまずく
摘む	つまむ
詰らない	つまらない
詰まり	つまり
積もり	つもり
露	つゆ
強まる	つよまる
強める	つよめる
連なる	つらなる
貫く	つらぬく
連ねる	つらねる
釣り	つり
吊り革	つりかわ
釣鐘	つりがね
吊るす	つるす
手当て	てあて
体	てい
提供	ていきょう
定義	ていぎ
提携	ていけい
体裁	ていさい
梯子	ていし
定食	ていしょく
提示	ていじ
訂正	ていせい
停滞	ていたい
邸宅	ていたく
定年	ていねん
堤防	ていぼう
手遅れ	ておくれ
手数	てかず
手掛かり	てがかり
手掛ける	てがける
手軽	てがる
的	てき
適応	てきおう
適宜	てきぎ
適性	てきせい
手際	てぎわ
手順	てじゅん
手錠	てじょう
手近	てぢか
	てっきり
鉄鋼	てっこう
徹する	てっする
鉄片	てっぺん
手配	てはい
手筈	てはず
手引き	てびき
手本	てほん
手回し	てまわし
手元	てもと
照り返す	てりかえす
手分け	てわけ
店	てん
点火	てんか
転回	てんかい
転換	てんかん
転居	てんきょ
転勤	てんきん
点検	てんけん
転校	てんこう
天国	てんごく
天才	てんさい
天災	てんさい
展示	てんじ
天井	てんじょう
転じる	てんじる
点線	てんせん
天体	てんたい
転転	てんてん
	てんで
転任	てんにん
展望	てんぼう
転落	てんらく
出合う	であう
出入り口	でいりぐち
	でかい
出来物	できもの
出切る	できる
出くわす	でくわす
出鱈目	でたらめ
出直し	でなおし
田園	でんえん
電源	でんげん
伝説	でんせつ
電線	でんせん
伝達	でんたつ
伝来	でんらい
	と
問い合わせる	といあわせる
問屋	といや
問う	とう
棟	とう
等	とう
陶器	とうき
等級	とうきゅう
討議	とうぎ
登校	とうこう
統合	とうごう
倒産	とうさん
投資	とうし
統治	とうじ
統制	とうせい
当選	とうせん
逃走	とうそう
統率	とうそつ
到達	とうたつ
到底	とうてい
丁々	とうとう
投入	とうにゅう
当人	とうにん
逃亡	とうぼう
冬眠	とうみん
登録	とうろく
討論	とうろん
遠ざかる	とおざかる
遠回り	とおまわり
通りかかる	とおりかかる
兎角	とかく
咎める	とがめる
時折	ときおり
跡切れる	とぎれる
説く	とく
特技	とくぎ
特産	とくさん
特集	とくしゅう
得点	とくてん
特派	とくは
特有	とくゆう
研ぐ	とぐ
刺	とげ
遂げる	とげる
床	とこ
所が	ところが
所で	ところで
年頃	としごろ
年寄り	としより
戸締り	とじまり
途上	とじょう
綴じる	とじる
途絶える	とだえる
特許	とっきょ
疾っくに	とっくに
特権	とっけん
咄嗟	とっさ
取っ手	とって
突破	とっぱ
突如	とつじょ
迚も	とても
整える	ととのえる
届け	とどけ
滞る	とどこおる
止まる	とどまる
留める	とどめる
止める	とどめる
唱える	となえる
兎に角	とにかく
殿様	とのさま
幕	とばり
帳	とばり
扉	とびら
徒歩	とほ
乏しい	とぼしい
富	とみ
富む	とむ
兎も角	ともかく
共稼ぎ	ともかせぎ
灯	ともしび
伴う	ともなう
共働き	ともばたらき
捕らえる	とらえる
取りあえず	とりあえず
取り扱い	とりあつかい
取り扱う	とりあつかう
鳥居	とりい
取り替え	とりかえ
取り組む	とりくむ
取り締まり	とりしまり
取り締まる	とりしまる
取り調べる	とりしらべる
取り立てる	とりたてる
取り次ぐ	とりつぐ
取り除く	とりのぞく
取り引き	とりひき
取り巻く	とりまく
取り混ぜる	とりまぜる
取り戻す	とりもどす
取り寄せる	とりよせる
取り分	とりわけ
副	とりわけ
蕩ける	とろける
	とんだ
胴	どう
働	どう
同	どう
同意	どうい
動員	どういん
同感	どうかん
動機	どうき
同級	どうきゅう
同居	どうきょ
動向	どうこう
同士	どうし
同志	どうし
如何して	どうして
如何しても	どうしても
同情	どうじょう
道場	どうじょう
何卒	どうぞ
どうぞ宜しく	どうぞよろしく
同調	どうちょう
動的	どうてき
同等	どうとう
堂々	どうどう
	どうにか
導入	どうにゅう
同封	どうふう
同盟	どうめい
	どうやら
動揺	どうよう
動力	どうりょく
独裁	どくさい
読者	どくしゃ
独自	どくじ
独占	どくせん
独創	どくそう
何処	どこ
何処か	どこか
土産	どさん
土台	どだい
何方	どちら
土手	どて
何方	どなた
怒鳴る	どなる
何の	どの
土俵	どひょう
土木	どぼく
何れ	どれ
何々	どれどれ
度忘れ	どわすれ
鈍感	どんかん
内閣	ないかく
乃至	ないし
内臓	ないぞう
内部	ないぶ
内乱	ないらん
内陸	ないりく
苗	なえ
尚	なお
尚更	なおさら
中程	なかほど
流し	ながし
長々	ながなが
殴る	なぐる
嘆く	なげく
投げ出す	なげだす
和やか	なごやか
名残	なごり
情け	なさけ
情け深い	なさけぶかい
為さる	なさる
詰る	なじる
何故	なぜ
何故なら	なぜなら
名高い	なだかい
雪崩	なだれ
懐く	なつく
名付ける	なづける
何気ない	なにげない
何しろ	なにしろ
何卒	なにとぞ
何も	なにも
何より	なにより
七日	なぬか
名札	なふだ
生臭い	なまぐさい
生温い	なまぬるい
生身	なまみ
鉛	なまり
鈍る	なまる
並み	なみ
滑らか	なめらか
嘗める	なめる
悩ましい	なやましい
悩ます	なやます
悩み	なやみ
平均	ならし
慣らす	ならす
馴らす	ならす
並びに	ならびに
成り立つ	なりたつ
成る丈	なるたけ
成るべく	なるべく
慣れ	なれ
馴れ馴れしい	なれなれしい
難	なん
南	なん
	なんか
何だか	なんだか
	なんだかんだ
何て	なんて
何と	なんと
何となく	なんとなく
何とも	なんとも
何なり	なんなり
荷	に
似通う	にかよう
面皰	にきび
賑わう	にぎわう
悪い	にくい
憎しみ	にくしみ
肉親	にくしん
肉体	にくたい
逃げ出す	にげだす
西日	にしび
滲む	にじむ
日夜	にちや
日当	にっとう
荷造り	にづくり
担う	になう
二人	ににん
にも拘らず	にもかかわらず
入手	にゅうしゅ
入賞	にゅうしょう
入浴	にゅうよく
尿	にょう
俄か	にわか
認識	にんしき
妊娠	にんしん
人情	にんじょう
任務	にんむ
任命	にんめい
抜かす	ぬかす
抜け出す	ぬけだす
盗み	ぬすみ
沼	ぬま
音	ね
値打ち	ねうち
寝かせる	ねかせる
捻子	ねじ
ねじ回し	ねじまわし
捻じれる	ねじれる
鼠	ねず
妬む	ねたむ
強請る	ねだる
熱湯	ねっとう
熱意	ねつい
熱量	ねつりょう
粘り	ねばり
粘る	ねばる
値引き	ねびき
根回し	ねまわし
眠たい	ねむたい
練る	ねる
念	ねん
年鑑	ねんかん
年号	ねんごう
燃焼	ねんしょう
年生	ねんせい
年長	ねんちょう
燃料	ねんりょう
年輪	ねんりん
脳	のう
農耕	のうこう
農場	のうじょう
農地	のうち
納入	のうにゅう
逃す	のがす
逃れる	のがれる
軒並み	のきなみ
鋸	のこぎり
望ましい	のぞましい
臨む	のぞむ
乗っ取る	のっとる
長閑	のどか
罵る	ののしる
延べ	のべ
飲み込む	のみこむ
乗り換え	のりかえ
乗り込む	のりこむ
刃	は
派	は
把握	はあく
肺	はい
廃棄	はいき
配給	はいきゅう
配偶者	はいぐうしゃ
拝啓	はいけい
背景	はいけい
背後	はいご
灰皿	はいさら
廃止	はいし
拝借	はいしゃく
排除	はいじょ
排水	はいすい
敗戦	はいせん
配置	はいち
配布	はいふ
配分	はいぶん
配慮	はいりょ
配列	はいれつ
映える	はえる
破壊	はかい
墓地	はかち
捗る	はかどる
果ない	はかない
諮る	はかる
図る	はかる
剥がす	はがす
破棄	はき
泊	はく
迫害	はくがい
薄弱	はくじゃく
白状	はくじょう
剥ぐ	はぐ
派遣	はけん
励ます	はげます
励む	はげむ
剥げる	はげる
鋏	はさみ
柱	はしら
橋渡し	はしわたし
恥	はじ
弾く	はじく
始め	はじめ
始めまして	はじめまして
恥じらう	はじらう
恥じる	はじる
蓮	はす
筈	はず
弾む	はずむ
破損	はそん
機	はた
果たして	はたして
果たす	はたす
裸足	はだし
蜂蜜	はちみつ
発掘	はっくつ
発生	はっせい
発足	はっそく
初	はつ
発	はつ
発育	はついく
発芽	はつが
発言	はつげん
発病	はつびょう
初耳	はつみみ
果て	はて
果てる	はてる
話し合い	はなしあい
甚だ	はなはだ
華々しい	はなばなしい
花びら	はなびら
華やか	はなやか
阻む	はばむ
浜	はま
浜辺	はまべ
填まる	はまる
歯磨	はみがき
填める	はめる
生やす	はやす
早める	はやめる
流行	はやり
腹立ち	はらだち
原っぱ	はらっぱ
張り紙	はりがみ
遥か	はるか
破裂	はれつ
腫れる	はれる
班	はん
判	はん
版	はん
繁栄	はんえい
反感	はんかん
版画	はんが
反響	はんきょう
判決	はんけつ
反撃	はんげき
反射	はんしゃ
繁殖	はんしょく
繁盛	はんじょう
反する	はんする
判定	はんてい
反応	はんのう
半端	はんぱ
反発	はんぱつ
反乱	はんらん
氾濫	はんらん
黴菌	ばいきん
賠償	ばいしょう
倍率	ばいりつ
馬鹿馬鹿しい	ばかばかしい
馬鹿らしい	ばからしい
漠然	ばくぜん
爆弾	ばくだん
爆破	ばくは
暴露	ばくろ
化ける	ばける
罰	ばち
伐	ばつ
	ばてる
発条	ばね
散蒔く	ばらまく
判	ばん
万	ばん
万人	ばんじん
万能	ばんのう
番目	ばんめ
非	ひ
費	ひ
延いては	ひいては
控室	ひかえしつ
控える	ひかえる
悲観	ひかん
匹	ひき
引き上げる	ひきあげる
率いる	ひきいる
引き受ける	ひきうける
引き起こす	ひきおこす
引き下げる	ひきさげる
引きずる	ひきずる
引き取る	ひきとる
引き分け	ひきわけ
否決	ひけつ
非行	ひこう
日頃	ひごろ
久しい	ひさしい
久し振り	ひさしぶり
悲惨	ひさん
秘書	ひしょ
比重	ひじゅう
密か	ひそか
浸す	ひたす
一向	ひたすら
左利き	ひだりきき
引っ掻く	ひっかく
引っ掛ける	ひっかける
必修	ひっしゅう
匹敵	ひってき
未	ひつじ
必然	ひつぜん
一息	ひといき
単	ひとえ
人柄	ひとがら
一頃	ひところ
人質	ひとじち
一筋	ひとすき
一まず	ひとまず
一人でに	ひとりでに
酷い	ひどい
日取り	ひどり
雛	ひな
日向	ひなた
非難	ひなん
避難	ひなん
日の丸	ひのまる
火花	ひばな
日々	ひび
悲鳴	ひめい
百科事典	ひゃっかじてん
百科辞典	ひゃっかじてん
冷やかす	ひやかす
日焼け	ひやけ
票	ひょう
標語	ひょうご
	ひょっと
平たい	ひらたい
比率	ひりつ
肥料	ひりょう
比例	ひれい
疲労	ひろう
広まる	ひろまる
貧困	ひんこん
品質	ひんしつ
品種	ひんしゅ
貧弱	ひんじゃく
頻繁	ひんぱん
美	び
微笑	びしょう
美術	びじゅつ
吃驚	びっくり
	びっしょり
描写	びょうしゃ
	びり
微量	びりょう
敏感	びんかん
貧乏	びんぼう
歩	ふ
不意	ふい
封	ふう
封鎖	ふうさ
風習	ふうしゅう
風俗	ふうぞく
風土	ふうど
不可欠	ふかけつ
深める	ふかめる
不吉	ふきつ
不況	ふきょう
布巾	ふきん
福	ふく
復旧	ふくきゅう
複合	ふくごう
福祉	ふくし
覆面	ふくめん
膨れる	ふくれる
不景気	ふけいき
老ける	ふける
布告	ふこく
富豪	ふごう
負債	ふさい
相応しい	ふさわしい
不在	ふざい
不山戯る	ふざける
負傷	ふしょう
不審	ふしん
不振	ふしん
不順	ふじゅん
付属	ふぞく
負担	ふたん
不調	ふちょう
復活	ふっかつ
復興	ふっこう
沸騰	ふっとう
仏	ふつ
不図	ふと
不当	ふとう
不動産	ふどうさん
赴任	ふにん
腐敗	ふはい
不評	ふひょう
不便	ふびん
不服	ふふく
普遍	ふへん
踏まえる	ふまえる
文	ふみ
不明	ふめい
扶養	ふよう
振り	ふり
振り出し	ふりだし
不良	ふりょう
浮力	ふりょく
震わせる	ふるわせる
付録	ふろく
分	ふん
憤慨	ふんがい
紛失	ふんしつ
噴出	ふんしゅつ
紛争	ふんそう
	ふんだん
奮闘	ふんとう
粉末	ふんまつ
部	ぶ
部下	ぶか
	ぶかぶか
侮辱	ぶじょく
武装	ぶそう
斑	ぶち
物資	ぶっし
物体	ぶったい
物議	ぶつぎ
打付ける	ぶつける
仏像	ぶつぞう
無難	ぶなん
部門	ぶもん
ぶら下げる	ぶらさげる
	ぶらぶら
武力	ぶりょく
無礼	ぶれい
文化財	ぶんかざい
分業	ぶんぎょう
文語	ぶんご
分散	ぶんさん
分子	ぶんし
文書	ぶんしょ
分担	ぶんたん
分配	ぶんぱい
分母	ぶんぼ
分離	ぶんり
分裂	ぶんれつ
兵器	へいき
閉口	へいこう
平行	へいこう
閉鎖	へいさ
兵士	へいし
平常	へいじょう
平方	へいほう
並列	へいれつ
辟易	へきえき
臍	へそ
隔たる	へだたる
謙る	へりくだる
経る	へる
編	へん
偏	へん
変革	へんかく
返還	へんかん
偏見	へんけん
返済	へんさい
変遷	へんせん
返答	へんとう
変動	へんどう
弁解	べんかい
便宜	べんぎ
弁護	べんご
弁償	べんしょう
弁論	べんろん
	ぺこぺこ
穂	ほ
保育	ほいく
倣	ほう
法案	ほうあん
崩壊	ほうかい
法学	ほうがく
放棄	ほうき
宝器	ほうき
封建	ほうけん
豊作	ほうさく
方策	ほうさく
奉仕	ほうし
方式	ほうしき
放射	ほうしゃ
放射能	ほうしゃのう
報酬	ほうしゅう
放出	ほうしゅつ
報じる	ほうじる
報ずる	ほうずる
放置	ほうち
法廷	ほうてい
報道	ほうどう
褒美	ほうび
葬る	ほうむる
放り込む	ほうりこむ
放り出す	ほうりだす
飽和	ほうわ
保温	ほおん
捕獲	ほかく
保管	ほかん
補給	ほきゅう
補強	ほきょう
保険	ほけん
捕鯨	ほげい
誇る	ほこる
綻びる	ほころびる
保護	ほご
乾	ほし
干し物	ほしもの
保守	ほしゅ
保障	ほしょう
補償	ほしょう
補充	ほじゅう
補助	ほじょ
舗装	ほそう
補足	ほそく
発作	ほっさ
	ほっと
頬っぺた	ほっぺた
辺り	ほとり
殆ど	ほとんど
解く	ほどく
施す	ほどこす
保母	ほぼ
保養	ほよう
捕吏	ほり
捕虜	ほりょ
滅びる	ほろびる
滅ぼす	ほろぼす
本格	ほんかく
本館	ほんかん
本気	ほんき
本質	ほんしつ
本体	ほんたい
本音	ほんね
本の	ほんの
本能	ほんのう
本場	ほんば
本文	ほんぶん
本名	ほんみょう
卯	ぼう
防衛	ぼうえい
防火	ぼうか
妨害	ぼうがい
紡績	ぼうせき
呆然	ぼうぜん
膨脹	ぼうちょう
冒頭	ぼうとう
暴動	ぼうどう
暴風	ぼうふう
暴力	ぼうりょく
募金	ぼきん
牧師	ぼくし
母校	ぼこう
没収	ぼっしゅう
坊ちゃん	ぼっちゃん
	ぼつぼつ
没落	ぼつらく
	ぼやく
	ぼやける
藍褸	ぼろ
枚	まい
埋蔵	まいぞう
舞う	まう
真上	まうえ
前売り	まえうり
前置き	まえおき
前もって	まえもって
任す	まかす
負かす	まかす
賄う	まかなう
曲がる	まがる
巻	まき
紛らわしい	まぎらわしい
紛れる	まぎれる
膜	まく
捲る	まくる
真心	まこころ
誠	まこと
真に	まことに
	まごつく
正しく	まさしく
正に	まさに
勝る	まさる
増し	まし
真下	ました
況して	まして
交える	まじえる
交わる	まじわる
麻酔	ますい
益々	ますます
不味い	まずい
股	また
跨がる	またがる
跨ぐ	またぐ
瞬き	またたき
待ち合わせ	まちあわせ
間違う	まちがう
待ち遠しい	まちどおしい
待ち望む	まちのぞむ
区々	まちまち
末期	まっき
真っ二つ	まっぷたつ
的	まと
纏まり	まとまり
纏め	まとめ
免れる	まぬかれる
招き	まねき
麻痺	まひ
眩しい	まぶしい
目蓋	まぶた
間々	まま
間もなく	まもなく
眉	まゆ
鞠	まり
丸ごと	まるごと
丸っきり	まるっきり
丸で	まるで
丸々	まるまる
丸める	まるめる
満月	まんげつ
満場	まんじょう
真ん中	まんなか
真ん前	まんまえ
真ん丸い	まんまるい
三	み
見合い	みあい
見合わせる	みあわせる
見落とす	みおとす
未開	みかい
味覚	みかく
見掛ける	みかける
三日月	みかずき
見方	みかた
見苦しい	みぐるしい
見込み	みこみ
未婚	みこん
惨め	みじめ
未熟	みじゅく
微塵	みじん
見すぼらしい	みすぼらしい
見せびらかす	みせびらかす
見せ物	みせもの
満たす	みたす
乱す	みだす
乱れる	みだれる
未知	みち
導く	みちびく
身近	みぢか
密集	みっしゅう
密接	みっせつ
見っともない	みっともない
蜜	みつ
密度	みつど
見積り	みつもり
未定	みてい
見通し	みとおし
源	みなもと
身なり	みなり
峰	みね
見逃す	みのがす
見晴らし	みはらし
身振り	みぶり
見舞	みまい
脈	みゃく
未練	みれん
見渡す	みわたす
民主	みんしゅ
民宿	みんしゅく
民族	みんぞく
民俗	みんぞく
六	む
無意味	むいみ
向き	むき
無口	むくち
向け	むけ
婿	むこ
無効	むこう
無言	むごん
毟る	むしる
無邪気	むじゃき
結び	むすび
結び付き	むすびつき
結び付く	むすびつく
結び付ける	むすびつける
無線	むせん
無駄遣い	むだづかい
無断	むだん
無知	むち
無茶	むちゃ
無茶苦茶	むちゃくちゃ
空しい	むなしい
無念	むねん
無能	むのう
無闇に	むやみに
無用	むよう
群がる	むらがる
無論	むろん
名産	めいさん
名称	めいしょう
命中	めいちゅう
名簿	めいぼ
名誉	めいよ
明瞭	めいりょう
明朗	めいろう
目方	めかた
恵み	めぐみ
恵む	めぐむ
目覚しい	めざましい
目覚める	めざめる
召す	めす
雌	めす
滅茶苦茶	めちゃくちゃ
目付き	めつき
滅亡	めつぼう
愛でたい	めでたい
目眩	めまい
目盛	めもり
面会	めんかい
免除	めんじょ
面する	めんする
面目	めんぼく
設ける	もうける
申し入れる	もうしいれる
申し込み	もうしこみ
申出	もうしで
申し出る	もうしでる
申し分	もうしぶん
盲点	もうてん
猛烈	もうれつ
藻掻く	もがく
目録	もくろく
目論見	もくろみ
模型	もけい
模索	もさく
若し	もし
若しかしたら	もしかしたら
若しかして	もしかして
若しかすると	もしかすると
若しくは	もしくは
若しも	もしも
齎らす	もたらす
凭れる	もたれる
持ち	もち
持ち切り	もちきり
物体ない	もったいない
以て	もって
専ら	もっぱら
持て成す	もてなす
持てる	もてる
基	もとい
物置き	ものおき
物好き	ものずき
物足りない	ものたりない
最早	もはや
模範	もはん
模倣	もほう
揉める	もめる
腿	もも
催す	もよおす
漏らす	もらす
盛り上がる	もりあがる
漏る	もる
漏れる	もれる
脆い	もろい
	もろに
問	もん
矢	や
哉	や
喧しい	やかましい
野外	やがい
軈て	やがて
夜行	やぎょう
役職	やくしょく
役立つ	やくだつ
役場	やくば
夜具	やぐ
優	やさ
屋敷	やしき
養う	やしなう
社	やしろ
野心	やしん
易い	やすい
安っぽい	やすっぽい
休める	やすめる
野生	やせい
矢鱈に	やたらに
夜中	やちゅう
奴	やっこ
やっ付ける	やっつける
矢っ張り	やっぱり
野党	やとう
病	やまい
闇	やみ
病む	やむ
止むを得ない	やむをえない
稍	やや
	ややこしい
遣り通す	やりとおす
やり遂げる	やりとげる
遣る	やる
和らげる	やわらげる
優位	ゆうい
憂鬱	ゆううつ
有益	ゆうえき
優越	ゆうえつ
勇敢	ゆうかん
有機	ゆうき
夕暮れ	ゆうぐれ
融資	ゆうし
有する	ゆうする
融通	ゆうずう
優勢	ゆうせい
優先	ゆうせん
誘導	ゆうどう
優美	ゆうび
有望	ゆうぼう
遊牧	ゆうぼく
夕焼け	ゆうやけ
有力	ゆうりょく
幽霊	ゆうれい
誘惑	ゆうわく
揺さぶる	ゆさぶる
茹でる	ゆでる
	ゆとり
指差す	ゆびさす
弓	ゆみ
揺らぐ	ゆらぐ
緩む	ゆるむ
緩める	ゆるめる
緩やか	ゆるやか
世	よ
好い	よい
要因	よういん
溶液	ようえき
用件	ようけん
養護	ようご
用紙	ようし
様式	ようしき
要する	ようする
要請	ようせい
養成	ようせい
様相	ようそう
用品	ようひん
洋風	ようふう
用法	ようほう
要望	ようぼう
余暇	よか
予感	よかん
余興	よきょう
預金	よきん
抑圧	よくあつ
浴室	よくしつ
抑制	よくせい
欲深い	よくふかい
欲望	よくぼう
寄こす	よこす
横綱	よこづな
葦	よし
善し悪し	よしあし
予想	よそう
余所見	よそみ
余地	よち
依って	よって
余程	よっぽど
与党	よとう
呼び止める	よびとめる
夜更かし	よふかし
夜更け	よふけ
読み上げる	よみあげる
寄り掛かる	よりかかる
宜しく	よろしく
弱まる	よわまる
弱める	よわめる
弱る	よわる
来場	らいじょう
酪農	らくのう
落下	らっか
楽観	らっかん
濫用	らんよう
理屈	りくつ
利根	りこん
利子	りし
利潤	りじゅん
理性	りせい
利息	りそく
立体	りったい
立法	りっぽう
利点	りてん
略語	りゃくご
略奪	りゃくだつ
流	りゅう
流通	りゅうつう
了	りょう
料	りょう
領域	りょういき
了解	りょうかい
領海	りょうかい
両極	りょうきょく
良好	りょうこう
良識	りょうしき
良質	りょうしつ
了承	りょうしょう
良心	りょうしん
領地	りょうち
領土	りょうど
両立	りょうりつ
旅客	りょかく
旅券	りょけん
履歴	りれき
理論	りろん
輪	りん
林業	りんぎょう
類似	るいじ
類推	るいすい
冷酷	れいこく
冷蔵	れいぞう
冷淡	れいたん
恋愛	れんあい
連休	れんきゅう
連日	れんじつ
連中	れんじゅう
連帯	れんたい
連邦	れんぽう
連盟	れんめい
老衰	ろうすい
朗読	ろうどく
浪費	ろうひ
労力	ろうりょく
碌な	ろくな
碌に	ろくに
露骨	ろこつ
論議	ろんぎ
論理	ろんり
和	わ
我がまま	わがまま
枠	わく
惑星	わくせい
技	わざ
態と	わざと
態々	わざわざ
煩わしい	わずらわしい
渡り鳥	わたりどり
詫び	わび
和風	わふう
和文	わぶん
藁	わら
割合に	わりあいに
割り当て	わりあて
割り込む	わりこむ
割り算	わりざん
割引き	わりびき
悪者	わるもの
	アイデア
	アクセル
	アップ
	アプローチ
	アマチュア
	アラブ
	アルカリ
	アルミ
	アワー
	アンケート
	アンコール
	イエス
	インターチェンジ
	インターナショナル
	インターフォン
	インテリ
	インフォメーション
	インフレ
	ウェートレス
	エアメール
	エレガント
	エンジニア
	オーケー
	オートマチック
	オープン
	オリエンテーション
	オレンジ
	オンライン
	カーペット
	カクテル
	カット
	カテゴリー
	カムバック
	カメラマン
	カルテ
	カンニング
	ガイド
	ガイドブック
	ガレージ
	キャッチ
	キャリア
	クイズ
	クラブ
	クレーン
	グラフ
	グレー
	ゲスト
	コーナー
	コマーシャル
	コミュニケーション
	コメント
	コンタクト
	コンテスト
	コントラスト
	コントロール
	コンパス
	サイクル
	サイズ
	サボる
	サンキュー
	サンタクロース
	シート
	システム
	シック
	シナリオ
	ショー
	ショック
	ジーパン
	ジャズ
	ジャンパー
	ジャンプ
	ジャンボ
	ジャンル
	スタジオ
	スチーム
	ストライキ
	ストレス
	ストロー
	ストロボ
	スピード
	スプリング
	スペース
	スポーツカー
	スラックス
	セール
	セクション
	セックス
	セレモニー
	センス
	ゼリー
	ソース
	ソックス
	ソロ
	タイトル
	タイピスト
	タイマー
	タイミング
	タイム
	タイムリー
	タイヤ
	タイル
	タレント
	タワー
	ダース
	ダウン
	ダブる
	ダンプ
	チームワーク
	チェンジ
	チャイム
	チャンネル
	ティッシュペーパー
	テレックス
	データ
	デコレーション
	デザート
	デザイン
	デッサン
	デモンストレーション
	トーン
	トラブル
	トランジスター
	ドライ
	ドライクリーニング
	ドライバー
	ドライブイン
	ドリル
	ナイター
	ナプキン
	ナンセンス
	ニュー
	ニュアンス
	ネガ
	ノイローゼ
	ハンガー
	バー
	バッジ
	バット
	パジャマ
	パチンコ
	パトカー
	パンク
	ヒント
	ビールス
	ビジネス
	ファイト
	ファイル
	ファン
	フィルター
	フェリー
	フォーム
	フロント
	ブーツ
	ブーム
	ブザー
	ブルー
	ベース
	ベスト
	ベストセラー
	ペア
	ホース
	ホール
	ボイコット
	ボルト
	ポーズ
	ポイント
	ポジション
	ポット
	ポンプ
	マーク
	マスコミ
	マッサージ
	ミスプリント
	ミセス
	ミュージック
	ミリ
	ムード
	メーカー
	メッセージ
	メディア
	メロディー
	モーテル
	モニター
	ヤング
	ユニーク
	ユニフォーム
	ライス
	ラベル
	ランプ
	ルーズ
	ルール
	レース
	レギュラー
	レクリエーション
	レッスン
	レディー
	レバー
	レンジ
	レンタカー
	レントゲン
	ロープ
ローマ字	ローマじ
	ロマンチック
	ワット
	あっ
愛	あい
	あいかわらず
挨拶	あいさつ
愛情	あいじょう
合図	あいず
	アイスクリーム
愛する	あいする
相手	あいて
	アイデア/アイディア
	あいにく
	あいまい
	アイロン
遭う	あう
	アウト
扇ぐ	あおぐ
青白い	あおじろい
明かり	あかり
	あかんぼう
明き	あき
空き	あき
明らか	あきらか
諦める	あきらめる
飽きる	あきる
	あきれる
握手	あくしゅ
	アクセント
	あくび
悪魔	あくま
飽くまで	あくまで
明け方	あけがた
明ける	あける
揚げる	あげる
挙げる	あげる
	あげる (=やる)
憧れる	あこがれる
足跡	あしあと
	あした
味わう	あじわう
預かる	あずかる
預ける	あずける
汗	あせ
与える	あたえる
暖かい	あたたか(い)
暖まる	あたたまる
暖める	あたためる
辺り	あたり
	あたりまえ
当たる	あたる
	あちこち
あひら	あひら
	あちらこちら
扱う	あつかう
厚かましい	あつかましい
圧縮	あっしゅく
集まり	あつまり
宛名	あてな
	あてはまる
	あてはめる
当てる	あてる
跡	あと
	あと
穴	あな
暴れる	あばれる
浴びる	あびる
油	あぶら
脂	あぶら
	あぶる
	あふれる
雨戸	あまど
甘やかす	あまやかす
余り	あまり
余る	あまる
編物	あみもの
編む	あむ
危うい	あやうい
怪しい	あやしい
誤り	あやまり
粗	あら
荒い	あらい
粗い	あらい
嵐	あらし
	あらすじ
争う	あらそう
新た	あらた
改めて	あらためて
改める	あらためる
	あらゆる
表す	あらわす
現す	あらわす
著す	あらわす
現れ	あらわれ
現れる	あらわれる
有難い	ありがたい
	ありがとう
有る	ある
在る	ある
或	ある
	あるいは
	アルバム
	あれこれ
泡	あわ
合わせる	あわせる
	あわただしい
	あわてる
哀れ	あわれ
案	あん
安易	あんい
案外	あんがい
暗記	あんき
安定	あんてい
	アンテナ
案内	あんない
	あんなに
	あんまり
胃	い
	いい
	よい
いえ	いえ
言い出す	いいだす
言い付ける	いいつける
委員	いいん
言う	ゆう
意外	いがい
行き	いき
行き	ゆき
息	いき
意義	いぎ
生き生き	いきいき
勢い	いきおい
	いきなり
生き物	いきもの
育児	いくじ
幾つ	いくつ
幾分	いくぶん
幾ら	いくら
	いけない
生け花	いけばな
以後	いご
以降	いこう
	イコール
勇ましい	いさましい
医師	いし
意思	いし
意志	いし
維持	いじ
意識	いしき
異常	いじょう
衣食住	いしょくじゅう
意地悪	いじわる
椅子	いす
泉	いずみ
	いずれ
以前	いぜん
板	いた
偉大	いだい
抱く	いだく
	いたずら
	いただきます
頂く	いただく
痛み	いたみ
至る	いたる
	いち
位置	いち
	いちいち
一応	いちおう
一時	いちじ
一段と	いちだんと
一度に	いちどに
市場	いちば
一番	いちばん
一流	いちりゅう
佚	いつ
	いつか
一家	いっか
一昨日	いっさくじつ
一昨年	いっさくねん
一種	いっしゅ
一瞬	いっしゅん
一生	いっしょう
一斉	いっせい
一層	いっそう
一体	いったい
一旦	いったん
一致	いっち
一定	いってい
	いっていらっしゃい
	いってらっしゃい
	いってまいります
	いつでも
	いつのまにか
一般	いっぱん
一方	いっぽう
	いつまでも
いつも	いつも
移転	いてん
井戸	いど
緯度	いど
移動	いどう
従兄弟	いとこ
従姉妹	いとこ
稲	いね
居眠り	いねむり
命	いのち
威張る	いばる
違反	いはん
衣服	いふく
居間	いま
今に	いまに
今にも	いまにも
否	いや
嫌がる	いやがる
	いよいよ
以来	いらい
依頼	いらい
	いらいら
	いらっしゃい
医療	いりょう
煎る	いる
炒る	いる
入れ物	いれもの
岩	いわ
祝い	いわい
祝う	いわう
言わば	いわば
	いわゆる
	インク
	インキ
印刷	いんさつ
印象	いんしょう
引退	いんたい
	インタビュー
引用	いんよう
引力	いんりょく
	ウイスキー
	ウーマン
	ウール
上	うわ
	ウエートレス
植木	うえき
飢える	うえる
魚	うお
	うがい
伺う	うかがう
浮ぶ	うかぶ
浮かべる	うかべる
浮く	うく
承る	うけたまわる
受取	うけとり
受け取る	うけとる
受け持つ	うけもつ
動かす	うごかす
兎	うさぎ
牛	うし
失う	うしなう
後	うしろ
薄暗い	うすぐらい
薄める	うすめる
嘘	うそ
疑う	うたがう
内	うち
打合せ	うちあわせ
打ち消す	うちけす
宇宙	うちゅう
討つ	うつ
撃つ	うつ
	うっかり
映す	うつす
移す	うつす
訴える	うったえる
写る	うつる
映る	うつる
	うどん
	うなる
奪う	うばう
馬	うま
うまい	うまい
生まれ	うまれ
有無	うむ
梅	うめ
埋める	うめる
敬う	うやまう
裏返す	うらがえす
裏切る	うらぎる
裏口	うらぐち
占う	うらなう
恨み	うらみ
恨む	うらむ
羨ましい	うらやましい
羨む	うらやむ
売上	うりあげ
売り切れ	うりきれ
売り切れる	うりきれる
	うるさい
嬉しい	うれしい
売行き	うれゆき
売れる	うれる
	うろうろ
噂	うわさ
うん	（感）
運	うん
運河	うんが
運転	うんてん
	うんと
運動	うんどう
柄	え
永遠	えいえん
永久	えいきゅう
影響	えいきょう
営業	えいぎょう
衛星	えいせい
英文	えいぶん
栄養	えいよう
英和	えいわ
	ええと
笑顔	えがお
描く	えがく
液体	えきたい
餌	えさ
	エチケット
	エネルギー
絵の具	えのぐ
	エプロン
偉い	えらい
得る	える
得る	うる
円	えん
宴会	えんかい
延期	えんき
演技	えんぎ
園芸	えんげい
演劇	えんげき
円周	えんしゅう
援助	えんじょ
	エンジン
演説	えんぜつ
演奏	えんそう
遠足	えんそく
延長	えんちょう
煙突	えんとつ
遠慮	えんりょ
御	お
老い	おい
追い掛ける	おいかける
追い越す	おいこす
追い付く	おいつく
	オイル
王	おう
追う	おう
応援	おうえん
王様	おうさま
王子	おうじ
王女	おうじょ
応じる	おうじる
応ずる	おうずる
応接	おうせつ
応対	おうたい
横断	おうだん
往復	おうふく
欧米	おうべい
応用	おうよう
終える	おえる
大いに	おおいに
覆う	おおう
	オーケストラ
	おおざっぱ
大通り	おおどおり
	オートメーション
	オーバー
	オーバーコート
大家	おおや
大凡	おおよそ
丘	おか
お帰り	おかえり
	おかけください
	おかげさまで
	おかず
拝む	おがむ
お代わり	おかわり
沖	おき
補う	おぎなう
	おきのどくに
奥	おく
屋外	おくがい
	おくさん
送り仮名	おくりがな
贈る	おくる
	おげんきで
怠る	おこたる
起こる	おこる
押える	おさえる
	おさきに
幼い	おさない
収める	おさめる
納める	おさめる
治める	おさめる
惜しい	おしい
	おじいさん
御辞儀	おじぎ
伯父さん	おじさん
小父さん	おじさん
叔父さん	おじさん
	おしゃれ
	おしゃべり
	おじゃまします
汚染	おせん
	おそらく
恐れる	おそれる
恐ろしい	おそろしい
教わる	おそわる
	おだいじに
お互い	おたがい
穏やか	おだやか
落着く	おちつく
御手洗	おてあらい
お出掛け	おでかけ
お手伝いさん	おてつだいさん
	おどかす
男の人	おとこのひと
落し物	おとしもの
	おととい
	おととし
	おとなしい
劣る	おとる
驚かす	おどろかす
お腹	おなか
鬼	おに
	おねがいします
各々	おのおの
伯母さん	おばさん
叔母さん	おばさん
	おはよう
帯	おび
お昼	おひる
	オフィス
溺れる	おぼれる
お参り	おまいり
	おまえ
	おまたせしました
	おまちください
	おまちどおさま
	おめでたい
	おめでとう
お目に掛かる	おめにかかる
思い掛けない	おもいがけない
思い込む	おもいこむ
思いっ切り	おもいっきり
思い付く	おもいつく
思い出	おもいで
重たい	おもたい
主に	おもに
思わず	おもわず
	おや
	おやすみ
	おやつ
親指	おやゆび
泳ぎ	およぎ
	およそ
及ぼす	およぼす
居る	おる
	オルガン
下す	おろす
降ろす	おろす
卸す	おろす
終	おわり
音	おん
恩	おん
恩恵	おんけい
温室	おんしつ
温泉	おんせん
温帯	おんたい
温暖	おんだん
御中	おんちゅう
温度	おんど
女の人	おんなのひと
可	か
蚊	か
課	か
	カー
	カード
	カーブ
会	かい
回	かい
貝	かい
害	がい
会員	かいいん
絵画	かいが
開会	かいかい
海外	かいがい
会館	かいかん
会計	かいけい
解決	かいけつ
会合	かいごう
外交	がいこう
改札	かいさつ
解散	かいさん
開始	かいし
解釈	かいしゃく
外出	がいしゅつ
海水浴	かいすいよく
回数	かいすう
回数券	かいすうけん
改正	かいせい
快晴	かいせい
解説	かいせつ
改善	かいぜん
改造	かいぞう
開通	かいつう
快適	かいてき
回転	かいてん
解答	かいとう
回答	かいとう
外部	がいぶ
回復	かいふく
解放	かいほう
開放	かいほう
海洋	かいよう
概論	がいろん
飼う	かう
帰す	かえす
却って	かえって
代える	かえる
替える	かえる
換える	かえる
反る	かえる
家屋	かおく
香り	かおり
画家	がか
抱える	かかえる
価格	かかく
化学	かがく
輝く	かがやく
係	かかり
掛かる	かかる
罹る	かかる
係わる	かかわる
鍵	かぎ
書留	かきとめ
書取	かきとり
垣根	かきね
限る	かぎる
掻く	かく
描く	かく
嗅ぐ	かぐ
家具	かぐ
学	がく
額	がく
架空	かくう
覚悟	かくご
各自	かくじ
確実	かくじつ
学者	がくしゃ
拡充	かくじゅう
学習	がくしゅう
学術	がくじゅつ
隠す	かくす
拡大	かくだい
各地	かくち
拡張	かくちょう
角度	かくど
確認	かくにん
学年	がくねん
学部	がくぶ
格別	かくべつ
学問	がくもん
確率	かくりつ
学力	がくりょく
隠れる	かくれる
影	かげ
陰	かげ
掛け算	かけざん
可決	かけつ
欠ける	かける
加減	かげん
過去	かこ
籠	かご
火口	かこう
下降	かこう
囲む	かこむ
火災	かさい
重なる	かさなる
重ねる	かさねる
飾り	かざり
火山	かざん
貸し	かし
菓子	かし
家事	かじ
賢い	かしこい
	かしこまりました
貸し出し	かしだし
過失	かしつ
果実	かじつ
貸間	かしま
貸家	かしや
歌手	かしゅ
個所	かしょ
過剰	かじょう
	かじる
数	かず
課税	かぜい
下線	かせん
稼ぐ	かせぐ
	カセット
数える	かぞえる
加速	かそく
加速度	かそくど
型	かた
肩	かた
固い	かたい
堅い	かたい
硬い	かたい
方々	かたがた
片仮名	かたかな
片付く	かたづく
刀	かたな
塊	かたまり
固まる	かたまる
片道	かたみち
傾く	かたむく
片寄る	かたよる
語る	かたる
勝ち	かち
価値	かち
学科	がっか
学会	がっかい
	がっかり
活気	かっき
楽器	がっき
学期	がっき
学級	がっきゅう
担ぐ	かつぐ
括弧	かっこ
格好	かっこう
活字	かつじ
活動	かつどう
活躍	かつやく
活用	かつよう
活力	かつりょく
仮定	かてい
過程	かてい
課程	かてい
仮名	かな
悲しむ	かなしむ
仮名遣い	かなづかい
必ずしも	かならずしも
	かなり
金	かね
鐘	かね
加熱	かねつ
金持ち	かねもち
兼ねる	かねる
可能	かのう
	カバー
過半数	かはんすう
株	かぶ
被せる	かぶせる
被る	かぶる
釜	かま
構う	かまう
我慢	がまん
上	かみ
神	かみ
紙屑	かみくず
神様	かみさま
剃刀	かみそり
雷	かみなり
髪の毛	かみのけ
	ガム
科目	かもく
	かもしれない
貨物	かもつ
	かゆい
火曜	かよう
歌謡	かよう
空	から
殻	から
柄	がら
	カラー
	からかう
空っぽ	からっぽ
刈る	かる
	かるた
彼等	かれら
枯れる	かれる
	カロリー
川	かわ
河	かわ
皮	かわ
革	かわ
	かわいがる
	かわいそう
	かわいらしい
乾かす	かわかす
渇く	かわく
為替	かわせ
瓦	かわら
代る	かわる
缶	かん
勘	かん
考え	かんがえ
感覚	かんかく
間隔	かんかく
換気	かんき
観客	かんきゃく
環境	かんきょう
歓迎	かんげい
感激	かんげき
観光	かんこう
関西	かんさい
観察	かんさつ
感じ	かんじ
感謝	かんしゃ
患者	かんじゃ
鑑賞	かんしょう
勘定	かんじょう
感情	かんじょう
感じる	かんじる
感ずる	かんずる
感心	かんしん
関心	かんしん
関する	かんする
完成	かんせい
間接	かんせつ
完全	かんぜん
乾燥	かんそう
感想	かんそう
観測	かんそく
寒帯	かんたい
官庁	かんちょう
勘違い	かんちがい
缶詰	かんづめ
乾電池	かんでんち
関東	かんとう
感動	かんどう
監督	かんとく
観念	かんねん
乾杯	かんぱい
看板	かんばん
看病	かんびょう
冠	かんむり
管理	かんり
完了	かんりょう
関連	かんれん
漢和	かんわ
気圧	きあつ
議員	ぎいん
記憶	きおく
気温	きおん
機械	きかい
器械	きかい
議会	ぎかい
着替え	きがえ
期間	きかん
機関	きかん
機関車	きかんしゃ
企業	きぎょう
飢饉	ききん
効く	きく
器具	きぐ
期限	きげん
機嫌	きげん
気候	きこう
記号	きごう
刻む	きざむ
岸	きし
生地	きじ
記事	きじ
技師	ぎし
儀式	ぎしき
記者	きしゃ
基準	きじゅん
規準	きじゅん
起床	きしょう
傷	きず
着せる	きせる
基礎	きそ
期待	きたい
気体	きたい
帰宅	きたく
基地	きち
貴重	きちょう
議長	ぎちょう
	きちんと
	きつい
	きっかけ
気付く	きづく
	ぎっしり
気に入る	きにいる
記入	きにゅう
記念	きねん
機能	きのう
気の毒	きのどく
基盤	きばん
寄付	きふ
希望	きぼう
基本	きほん
決まり	きまり
気味	きみ
奇妙	きみょう
義務	ぎむ
疑問	ぎもん
逆	ぎゃく
客席	きゃくせき
客間	きゃくま
	キャプテン
	ギャング
	キャンパス
	キャンプ
九	きゅう
旧	きゅう
級	きゅう
球	きゅう
休暇	きゅうか
休業	きゅうぎょう
休憩	きゅうけい
急激	きゅうげき
休講	きゅうこう
吸収	きゅうしゅう
救助	きゅうじょ
急速	きゅうそく
休息	きゅうそく
急に	きゅうに
給与	きゅうよ
休養	きゅうよう
給料	きゅうりょう
清い	きよい
器用	きよう
強化	きょうか
境界	きょうかい
教科書	きょうかしょ
競技	きょうぎ
行儀	ぎょうぎ
供給	きょうきゅう
教師	きょうし
行事	ぎょうじ
教授	きょうじゅ
恐縮	きょうしゅく
強調	きょうちょう
共通	きょうつう
共同	きょうどう
恐怖	きょうふ
教養	きょうよう
協力	きょうりょく
強力	きょうりょく
行列	ぎょうれつ
許可	きょか
漁業	ぎょぎょう
局	きょく
曲線	きょくせん
巨大	きょだい
嫌う	きらう
霧	きり
規律	きりつ
斬る	きる
切れ	きれ
切れる	きれる
	キロ
記録	きろく
議論	ぎろん
気を付ける	きをつける
金	きん
銀	ぎん
禁煙	きんえん
金額	きんがく
金魚	きんぎょ
金庫	きんこ
禁止	きんし
金銭	きんせん
金属	きんぞく
近代	きんだい
緊張	きんちょう
筋肉	きんにく
金融	きんゆう
金曜	きんよう
九	く
句	く
区域	くいき
食う	くう
偶数	ぐうすう
偶然	ぐうぜん
空想	くうそう
空中	くうちゅう
	クーラー
釘	くぎ
区切る	くぎる
臭い	くさい
鎖	くさり
腐る	くさる
櫛	くし
	くしゃみ
苦情	くじょう
苦心	くしん
屑	くず
崩す	くずす
薬指	くすりゆび
崩れる	くずれる
癖	くせ
管	くだ
具体	ぐたい
砕く	くだく
砕ける	くだける
下さる	くださる
	くたびれる
	くだらない
下り	くだり
下る	くだる
唇	くちびる
口紅	くちべに
苦痛	くつう
	くっつく
	くっつける
	ぐっすり
	くどい
句読点	くとうてん
配る	くばる
工夫	くふう
区分	くぶん
区別	くべつ
組	くみ
組合	くみあい
組合せ	くみあわせ
組み立てる	くみたてる
組む	くむ
汲む	くむ
酌む	くむ
曇	くもり
悔しい	くやしい
悔やむ	くやむ
位	くらい
暮らし	くらし
	クラシック
暮らす	くらす
	グラス
	グランド
	クリーニング
	クリーム
繰り返す	くりかえす
	クリスマス
狂う	くるう
	グループ
苦しい	くるしい
苦しむ	くるしむ
	くるむ
暮れ	くれ
	くれぐれも
苦労	くろう
加える	くわえる
咥える	くわえる
詳しい	くわしい
加わる	くわわる
訓	くん
軍	ぐん
郡	ぐん
軍隊	ぐんたい
訓練	くんれん
下	げ
計	けい
敬意	けいい
経営	けいえい
計画	けいかく
景気	けいき
経験	けいけん
稽古	けいこ
敬語	けいご
傾向	けいこう
蛍光灯	けいこうとう
警告	けいこく
計算	けいさん
掲示	けいじ
刑事	けいじ
形式	けいしき
芸術	げいじゅつ
継続	けいぞく
毛糸	けいと
経度	けいど
系統	けいとう
芸能	げいのう
競馬	けいば
警備	けいび
契約	けいやく
経由	けいゆ
形容詞	けいようし
形容動詞	けいようどうし
	ケース
	ゲーム
怪我	けが
外科	げか
毛皮	けがわ
劇	げき
劇場	げきじょう
激増	げきぞう
下車	げしゃ
下旬	げじゅん
化粧	けしょう
下水	げすい
削る	けずる
桁	けた
下駄	げた
	けち
血圧	けつあつ
血液	けつえき
結果	けっか
欠陥	けっかん
月給	げっきゅう
結局	けっきょく
傑作	けっさく
決心	けっしん
欠席	けっせき
決定	けってい
欠点	けってん
月末	げつまつ
月曜	げつよう
結論	けつろん
気配	けはい
下品	げひん
煙い	けむい
煙	けむり
蹴る	ける
けれど/けれども	
険しい	けわしい
券	けん
県	けん
軒	けん
喧嘩	けんか
見解	けんかい
限界	げんかい
見学	けんがく
謙虚	けんきょ
現金	げんきん
言語	げんご
健康	けんこう
原稿	げんこう
検査	けんさ
現在	げんざい
原産	げんさん
原始	げんし
現実	げんじつ
研修	けんしゅう
厳重	げんじゅう
現象	げんしょう
現状	げんじょう
建設	けんせつ
謙遜	けんそん
現代	げんだい
建築	けんちく
県庁	けんちょう
限度	げんど
見当	けんとう
検討	けんとう
現に	げんに
現場	げんば
顕微鏡	けんびきょう
憲法	けんぽう
権利	けんり
原理	げんり
原料	げんりょう
後	ご
語	ご
碁	ご
恋	こい
濃い	こい
恋しい	こいしい
恋人	こいびと
請う	こう
工員	こういん
強引	ごういん
幸運	こううん
講演	こうえん
効果	こうか
硬貨	こうか
高価	こうか
豪華	ごうか
公害	こうがい
合格	ごうかく
交換	こうかん
高級	こうきゅう
公共	こうきょう
航空	こうくう
光景	こうけい
工芸	こうげい
合計	ごうけい
攻撃	こうげき
貢献	こうけん
孝行	こうこう
広告	こうこく
交差	こうさ
交際	こうさい
講師	こうし
工事	こうじ
公式	こうしき
口実	こうじつ
こうして	こうして
校舎	こうしゃ
後者	こうしゃ
公衆	こうしゅう
工場	こうば
香水	こうすい
公正	こうせい
構成	こうせい
功績	こうせき
光線	こうせん
高層	こうそう
構造	こうぞう
高速	こうそく
交替	こうたい
耕地	こうち
交通機関	こうつうきかん
校庭	こうてい
肯定	こうてい
高度	こうど
高等	こうとう
行動	こうどう
強盗	ごうとう
合同	ごうどう
後輩	こうはい
公表	こうひょう
幸福	こうふく
鉱物	こうぶつ
公平	こうへい
候補	こうほ
公務	こうむ
項目	こうもく
紅葉	こうよう
合理	ごうり
交流	こうりゅう
合流	ごうりゅう
考慮	こうりょ
効力	こうりょく
越える	こえる
超える	こえる
	コース
	コーチ
	コード
	コーラス
氷	こおり
凍る	こおる
	ゴール
誤解	ごかい
語学	ごがく
焦がす	こがす
呼吸	こきゅう
故郷	こきょう
極	ごく
国王	こくおう
国語	こくご
国籍	こくせき
黒板	こくばん
克服	こくふく
国民	こくみん
穀物	こくもつ
国立	こくりつ
	ごくろうさま
焦げる	こげる
ここ	ここ
凍える	こごえる
心当たり	こころあたり
心得る	こころえる
腰	こし
腰掛け	こしかけ
腰掛ける	こしかける
五十音	ごじゅうおん
故障	こしょう
胡椒	こしょう
	こしらえる
個人	こじん
越す	こす
超す	こす
擦る	こする
	ごぞんじですか
個体	こたい
御馳走	ごちそう
	ごちそうさま
	こちらこそ
国家	こっか
国会	こっかい
小遣い	こづかい
国境	こっきょう
	コック
骨折	こっせつ
	こっそり
小包	こづつみ
古典	こてん
事	こと
琴	こと
言付ける	ことづける
異なる	ことなる
言葉遣い	ことばづかい
諺	ことわざ
断る	ことわる
粉	こな
この	この
	こないだ
好み	このみ
好む	このむ
	コピー
御無沙汰	ごぶさた
	こぼす
	こぼれる
塵	ごみ
塵芥	ごみ
	ゴム
小麦	こむぎ
御免	ごめん
	ごめんください
	ごめんなさい
小屋	こや
小指	こゆび
	こらえる
娯楽	ごらく
御覧	ごらん
	コレクション
	これら
頃	ころ
転がす	ころがす
転がる	ころがる
殺す	ころす
転ぶ	ころぶ
紺	こん
今回	こんかい
	コンクール
	コンクリート
今後	こんご
混合	こんごう
混雑	こんざつ
	コンセント
献立	こんだて
	こんなに
困難	こんなん
今日	こんにち
	こんにちは
	こんばんは
	コンピューター
婚約	こんやく
混乱	こんらん
差	さ
	サークル
	サービス
際	さい
在学	ざいがく
最高	さいこう
再三	さいさん
財産	ざいさん
祭日	さいじつ
最終	さいしゅう
催促	さいそく
最中	さいちゅう
最低	さいてい
採点	さいてん
災難	さいなん
才能	さいのう
裁判	さいばん
裁縫	さいほう
材木	ざいもく
材料	ざいりょう
	サイレン
幸い	さいわい
	サイン
境	さかい
逆さ	さかさ
逆様	さかさま
捜す	さがす
遡る	さかのぼる
酒場	さかば
逆らう	さからう
盛り	さかり
	さきおととい
先程	さきほど
作業	さぎょう
裂く	さく
昨	さく
索引	さくいん
作者	さくしゃ
削除	さくじょ
作成	さくせい
作製	さくせい
作品	さくひん
作物	さくもつ
桜	さくら
探る	さぐる
酒	さけ
叫ぶ	さけぶ
避ける	さける
支える	ささえる
囁く	ささやく
刺さる	ささる
匙	さじ
座敷	ざしき
差し支え	さしつかえ
差し引き	さしひき
刺身	さしみ
刺す	さす
指す	さす
挿す	さす
注す	さす
射す	さす
流石	さすが
座席	ざせき
誘う	さそう
札	さつ
撮影	さつえい
雑音	ざつおん
作家	さっか
作曲	さっきょく
	さっさと
早速	さっそく
	ざっと
	さっぱり
	さて
砂漠	さばく
錆	さび
錆びる	さびる
座布団	ざぶとん
差別	さべつ
作法	さほう
様々	さまざま
冷ます	さます
覚ます	さます
妨げる	さまたげる
冷める	さめる
覚める	さめる
左右	さゆう
	さようなら
皿	さら
再来月	さらいげつ
再来週	さらいしゅう
再来年	さらいねん
更に	さらに
	サラリーマン
去る	さる
猿	さる
騒がしい	さわがしい
騒ぎ	さわぎ
	さわやか
参加	さんか
三角	さんかく
参考	さんこう
算数	さんすう
賛成	Uӣ[い
酸性	さんせい
酸素	さんそ
産地	さんち
	サンプル
散歩	さんぽ
山林	さんりん
四	し
氏	し
詩	し
仕上がる	しあがる
	しあさって
幸せ	しあわせ
	シーズン
	シーツ
寺院	じいん
しいんと	（する）
	ジーンズ
自衛	じえい
ジェット機	ジェットき
塩辛い	しおからい
司会	しかい
四角	しかく
四角い	しかくい
直に	じかに
	しかも
叱る	しかる
時間割	じかんわり
式	しき
四季	しき
直	じき
時期	じき
敷地	しきち
支給	しきゅう
至急	しきゅう
	しきりに
敷く	しく
刺激	しげき
茂る	しげる
資源	しげん
事件	じけん
時刻	じこく
自殺	じさつ
持参	じさん
事実	じじつ
磁石	じしゃく
四捨五入	ししゃごにゅう
始終	しじゅう
自習	じしゅう
支出	ししゅつ
事情	じじょう
詩人	しじん
自身	じしん
静まる	しずまる
沈む	しずむ
姿勢	しせい
自然科学	しぜんかがく
自然	しぜん
思想	しそう
時速	じそく
子孫	しそん
舌	した
死体	したい
次第	しだい
事態	じたい
従う	したがう
下書き	したがき
したがって	したがって
支度	したく
親しい	したしい
下町	したまち
七	しち
自治	じち
質	しつ
実感	じっかん
失業	しつぎょう
湿気	しっけ
湿気	しっき
実験	じっけん
実現	じつげん
	しつこい
実行	じっこう
実際	じっさい
実施	じっし
実習	じっしゅう
実績	じっせき
湿度	しつど
	じっと
実に	じつに
実は	じつは
執筆	しっぴつ
実物	じつぶつ
	しっぽ
失望	しつぼう
実用	じつよう
実力	じつりょく
実例	じつれい
失恋	しつれん
指定	してい
私鉄	してつ
支店	してん
指導	しどう
自動	じどう
児童	じどう
品	しな
支配	しはい
芝居	しばい
	しばしば
芝生	しばふ
支払	しはらい
支払う	しはらう
縛る	しばる
地盤	じばん
	しびれる
紙幣	しへい
死亡	しぼう
	しぼむ
絞る	しぼる
資本	しほん
縞	しま
しまい	（終わり）
姉妹	しまい
しまう	（終わる）
しまった	（感）
自慢	じまん
地味	じみ
	しみじみ
事務	じむ
氏名	しめい
締切	しめきり
締め切る	しめきる
示す	しめす
占める	しめる
湿る	しめる
下	しも
霜	しも
	じゃあ
	ジャーナリスト
社会科学	しゃかいかがく
	しゃがむ
蛇口	じゃぐち
弱点	じゃくてん
車庫	しゃこ
車掌	しゃしょう
写生	しゃせい
社説	しゃせつ
借金	しゃっきん
	しゃっくり
	シャッター
	しゃぶる
	しゃべる
邪魔	じゃま
車輪	しゃりん
洒落	しゃれ
	じゃんけん
週	しゅう
州	しゅう
十	じゅう
銃	じゅう
周囲	しゅうい
集会	しゅうかい
収穫	しゅうかく
週間	しゅうかん
住居	じゅうきょ
宗教	しゅうきょう
集金	しゅうきん
集合	しゅうごう
習字	しゅうじ
重視	じゅうし
就職	しゅうしょく
	ジュース
修正	しゅうせい
修繕	しゅうぜん
重体	じゅうたい
渋滞	じゅうたい
重大	じゅうだい
住宅	じゅうたく
集団	しゅうだん
じゅうたん	（カーペット）
集中	しゅうちゅう
終点	しゅうてん
重点	じゅうてん
収入	しゅうにゅう
就任	しゅうにん
周辺	しゅうへん
住民	じゅうみん
重役	じゅうやく
重要	じゅうよう
修理	しゅうり
終了	しゅうりょう
重量	じゅうりょう
重力	じゅうりょく
主義	しゅぎ
熟語	じゅくご
祝日	しゅくじつ
縮小	しゅくしょう
宿泊	しゅくはく
受験	じゅけん
主語	しゅご
手術	しゅじゅつ
首相	しゅしょう
手段	しゅだん
主張	しゅちょう
出勤	しゅっきん
述語	じゅつご
出身	しゅっしん
出席	しゅっせき
出張	しゅっちょう
出発	しゅっぱつ
出版	しゅっぱん
首都	しゅと
主婦	しゅふ
寿命	じゅみょう
主役	しゅやく
主要	しゅよう
需要	じゅよう
種類	しゅるい
受話器	じゅわき
順	じゅん
瞬間	しゅんかん
循環	じゅんかん
巡査	じゅんさ
順々	じゅんじゅん
順序	じゅんじょ
純情	じゅんじょう
純粋	じゅんすい
順調	じゅんちょう
順番	じゅんばん
準備	じゅんび
使用	しよう
小	しょう
章	しょう
賞	しょう
上	じょう
消化	しょうか
障害	しょうがい
奨学金	しょうがくきん
小学生	しょうがくせい
	しょうがない
将棋	しょうぎ
蒸気	じょうき
定規	じょうぎ
乗客	じょうきゃく
上級	じょうきゅう
商業	しょうぎょう
上京	じょうきょう
状況	じょうきょう
消極的	しょうきょくてき
賞金	しょうきん
上下	じょうげ
条件	じょうけん
正午	しょうご
障子	しょうじ
正直	しょうじき
常識	じょうしき
商社	しょうしゃ
乗車	じょうしゃ
上旬	じょうじゅん
少女	しょうじょ
少々	しょうしょう
症状	しょうじょう
生じる	しょうじる
生ずる	しょうずる
小数	しょうすう
招待	しょうたい
状態	じょうたい
上達	じょうたつ
冗談	じょうだん
承知	しょうち
商店	しょうてん
焦点	しょうてん
上等	じょうとう
消毒	しょうどく
衝突	しょうとつ
商人	しょうにん
承認	しょうにん
少年	しょうねん
勝敗	しょうはい
商売	しょうばい
蒸発	じょうはつ
消費	しょうひ
商品	しょうひん
賞品	しょうひん
勝負	しょうぶ
小便	しょうべん
消防	しょうぼう
消防署	しょうぼうしょ
情報	じょうほう
正味	しょうみ
証明	しょうめい
正面	しょうめん
消耗	しょうもう
醤油	しょうゆ
省略	しょうりゃく
女王	じょおう
初級	しょきゅう
助教授	じょきょうじゅ
職	しょく
食塩	しょくえん
職業	しょくぎょう
食事	しょくじ
食卓	しょくたく
職人	しょくにん
食品	しょくひん
植物	しょくぶつ
食物	しょくもつ
食欲	しょくよく
食料	しょくりょう
食糧	しょくりょう
書斎	しょさい
女子	じょし
助手	じょしゅ
初旬	しょじゅん
徐々に	じょじょに
書籍	しょせき
食器	しょっき
	ショップ
書店	しょてん
書道	しょどう
署名	しょめい
書物	しょもつ
女優	じょゆう
処理	しょり
書類	しょるい
白髪	しらが
知らせ	しらせ
尻	しり
知合い	しりあい
	シリーズ
私立	しりつ
資料	しりょう
汁	しる
印	しるし
城	しろ
素人	しろうと
芯	しん
進学	しんがく
新幹線	しんかんせん
真空	しんくう
神経	しんけい
真剣	しんけん
信仰	しんこう
信号	しんごう
人工	じんこう
深刻	しんこく
診察	しんさつ
人種	じんしゅ
信じる	しんじる
信ずる	しんずる
心身	しんしん
申請	しんせい
人生	じんせい
親戚	しんせき
新鮮	しんせん
心臓	しんぞう
人造	じんぞう
身体	しんたい
寝台	しんだい
診断	しんだん
身長	しんちょう
慎重	しんちょう
侵入	しんにゅう
心配	しんぱい
審判	しんぱん
人物	じんぶつ
人文科学	じんぶんかがく
進歩	しんぽ
人命	じんめい
深夜	しんや
親友	しんゆう
信用	しんよう
信頼	しんらい
心理	しんり
森林	しんりん
親類	しんるい
人類	じんるい
針路	しんろ
神話	しんわ
巣	す
酢	す
図	ず
水産	すいさん
炊事	すいじ
水準	すいじゅん
水蒸気	すいじょうき
推薦	すいせん
水素	すいそ
垂直	すいちょく
	スイッチ
推定	すいてい
水滴	すいてき
水筒	すいとう
随筆	ずいひつ
水分	すいぶん
随分	ずいぶん
水平	すいへい
水平線	すいへいせん
睡眠	すいみん
水曜	すいよう
数	すう
数字	すうじ
	ずうずうしい
	ずうっと
	スープ
末	すえ
末っ子	すえっこ
姿	すがた
	スカーフ
図鑑	ずかん
杉	すぎ
	スキー
好き嫌い	すききらい
好き好き	すきずき
透き通る	すきとおる
隙間	すきま
空く	すく
救う	すくう
	スクール
	すくなくとも
優れる	すぐれる
図形	ずけい
	スケート
	スケジュール
	すごい
少しも	すこしも
過ごす	すごす
筋	すじ
鈴	すず
涼む	すずむ
進める	すすめる
勧める	すすめる
	スター
	スタート
	スタイル
	スタンド
	スチュワーデス
頭痛	ずつう
	すっきり
	ずっと
	すっぱい
	ステージ
	すてき
既に	すでに
棄てる	すてる
	ストッキング
	ストップ
素直	すなお
	すなわち
頭脳	ずのう
素晴らしい	すばらしい
	スピーカー
	スピーチ
図表	ずひょう
全て	すべて
	スマート
住まい	すまい
済ませる	すませる
	すまない
角	すみ
墨	すみ
すみません	（感）
澄む	すむ
清む	すむ
相撲	すもう
	スライド
	ずらす
	ずらり
掏摸	すり
刷る	する
為る	する
狡い	ずるい
すると	すると
鋭い	するどい
	すれちがう
滑れる	ずれる
寸法	すんぽう
背	せい
正	せい
生	せい
性	せい
姓	せい
所為	せい
税	ぜい
性格	せいかく
正確	せいかく
税関	ぜいかん
世紀	せいき
請求	せいきゅう
税金	ぜいきん
清潔	せいけつ
制限	せいげん
成功	せいこう
製作	せいさく
制作	せいさく
生産	せいさん
正式	せいしき
性質	せいしつ
清書	せいしょ
青少年	せいしょうねん
精神	せいしん
成人	せいじん
整数	せいすう
精々	せいぜい
成績	せいせき
清掃	せいそう
製造	せいぞう
生存	せいぞん
贅沢	ぜいたく
成長	せいちょう
生長	せいちょう
制度	せいど
政党	せいとう
青年	せいねん
生年月日	せいねんがっぴ
性能	せいのう
整備	せいび
製品	せいひん
政府	せいふ
生物	せいぶつ
成分	せいぶん
性別	せいべつ
正方形	せいほうけい
生命	せいめい
正門	せいもん
整理	せいり
成立	せいりつ
西暦	せいれき
背負う	せおう
咳	せき
石炭	せきたん
赤道	せきどう
責任	せきにん
石油	せきゆ
世間	せけん
説	せつ
折角	せっかく
積極的	せっきょくてき
接近	せっきん
設計	せっけい
石鹸	せっけん
接する	せっする
	せっせと
接続	せつぞく
絶対	ぜったい
	セット
設備	せつび
絶滅	ぜつめつ
節約	せつやく
瀬戸物	せともの
是非	ぜひ
	ぜひとも
迫る	せまる
	ゼミ
	せめて
攻める	せめる
責める	せめる
	セメント
世話	せわ
栓	せん
善	ぜん
全	ぜん
全員	ぜんいん
前後	ぜんご
専攻	せんこう
全国	ぜんこく
洗剤	せんざい
先日	せんじつ
前者	ぜんしゃ
選手	せんしゅ
全集	ぜんしゅう
全身	ぜんしん
前進	ぜんしん
扇子	せんす
専制	せんせい
全然	ぜんぜん
先々月	せんせんげつ
先々週	せんせんしゅう
先祖	せんぞ
	センター
全体	ぜんたい
選択	せんたく
先端	せんたん
	センチ
宣伝	せんでん
先頭	せんとう
全般	ぜんぱん
扇風機	せんぷうき
線路	せんろ
そう	そう
象	ぞう
相違	そうい
	そういえば
騒音	そうおん
増加	ぞうか
雑巾	ぞうきん
増減	ぞうげん
倉庫	そうこ
相互	そうご
操作	そうさ
創作	そうさく
掃除	そうじ
葬式	そうしき
	そうして
造船	ぞうせん
想像	そうぞう
騒々しい	そうぞうしい
相続	そうぞく
増大	ぞうだい
相談	そうだん
装置	そうち
	そうっと
相当	そうとう
送別	そうべつ
草履	ぞうり
総理大臣	そうりだいじん
送料	そうりょう
属する	ぞくする
続々	ぞくぞく
速達	そくたつ
測定	そくてい
速度	そくど
測量	そくりょう
速力	そくりょく
そこ	そこ
底	そこ
	そこで
組織	そしき
素質	そしつ
	そして
祖先	そせん
注ぐ	そそぐ
	そそっかしい
育つ	そだつ
	そっくり
卒直	そっちょく
	そっと
袖	そで
備える	そなえる
具える	そなえる
その	その
	そのうえ
	そのうち
	そのころ
	そのため
	そのほか
	そのまま
側	そば
蕎麦	そば
	ソファー
粗末	そまつ
剃る	そる
それ	（接。感）
	それぞれ
	それでも
	それと
	それとも
	それなのに
逸れる	それる
揃う	そろう
揃える	そろえる
算盤	そろばん
損	そん
損害	そんがい
尊敬	そんけい
存在	そんざい
存じる	ぞんじる
存ずる	ぞんずる
尊重	そんちょう
損得	そんとく
田	た
田ぼ	たんぼ
他	た
対	たい
大	だい
台	だい
題	だい
体育	たいいく
だいいち	（副）
退院	たいいん
体温	たいおん
大会	たいかい
大学院	だいがくいん
大気	たいき
代金	だいきん
大工	だいく
退屈	たいくつ
体系	たいけい
太鼓	たいこ
滞在	たいざい
対策	たいさく
大使	たいし
大した	たいした
大して	たいして
対象	たいしょう
対照	たいしょう
大小	だいしょう
大臣	だいじん
対する	たいする
体制	たいせい
体積	たいせき
大戦	たいせん
大層	たいそう
体操	たいそう
大抵	たいてい
態度	たいど
大統領	だいとうりょう
大半	たいはん
代表	だいひょう
大分	だいぶん
大部分	だいぶぶん
	タイプライター
大変	たいへん
逮捕	たいほ
大木	たいぼく
題名	だいめい
代名詞	だいめいし
	タイア
	ダイヤ
	ダイヤグラム
	ダイヤモンド
	ダイヤル
太陽	たいよう
平ら	たいら
代理	だいり
大陸	たいりく
Ͼ立	たいりつ
田植え	たうえ
絶えず	たえず
楕円	だえん
倒す	たおす
	タオル
だが	だが
互い	たがい
高める	たかめる
耕す	たがやす
宝	たから
だから	だから
滝	たき
宅	たく
炊く	たく
焚く	たく
蓄える	たくわえる
竹	たけ
	だけど
確かめる	たしかめる
多少	たしょう
助かる	たすかる
助ける	たすける
	ただ
只	ただ
唯	ただ
戦い	たたかい
戦う	たたかう
叩く	たたく
但し	ただし
直ちに	ただちに
畳む	たたむ
立ち上がる	たちあがる
立ち止まる	たちどまる
立場	たちば
	たちまち
建つ	たつ
発つ	たつ
経つ	たつ
達する	たっする
脱線	だっせん
唯	たった
	だって
	たっぷり
縦	たて
妥当	だとう
	たとえ
例える	たとえる
谷	たに
他人	たにん
種	たね
頼もしい	たのもしい
束	たば
足袋	たび
度	たび
旅	たび
	たびたび
	ダブル
多分	たぶん
玉	たま
球	たま
弾	たま
偶	たま
	だます
偶々	たまたま
	たまらない
溜まる	たまる
黙る	だまる
	ダム
駄目	だめ
溜息	ためいき
試し	ためし
試す	ためす
	ためらう
溜める	ためる
便り	たより
頼る	たよる
	だらしない
足る	たる
誰か	だれか
段	だん
単位	たんい
段階	だんかい
短期	たんき
単語	たんご
炭鉱	たんこう
男子	だんし
単純	たんじゅん
短所	たんしょ
誕生	たんじょう
	たんす
	ダンス
淡水	たんすい
断水	だんすい
単数	たんすう
団体	だんたい
団地	だんち
断定	だんてい
担当	たんとう
単なる	たんなる
単に	たんに
短編	たんぺん
地	ち
地位	ちい
地域	ちいき
	チーズ
	チーム
知恵	ちえ
地下	ちか
違い	ちがい
違いない	ちがいない
誓う	ちかう
近頃	ちかごろ
地下水	ちかすい
近々	ちかぢか
近付ける	ちかづける
近寄る	ちかよる
力強い	ちからづよい
地球	ちきゅう
	ちぎる
地区	ちく
遅刻	ちこく
知事	ちじ
知識	ちしき
地質	ちしつ
知人	ちじん
地帯	ちたい
父親	ちちおや
縮む	ちぢむ
縮める	ちぢめる
縮れる	ちぢれる
	チップ
地点	ちてん
知能	ちのう
地平線	ちへいせん
地方	ちほう
地名	ちめい
茶	ちゃ
茶色い	ちゃいろい
着々	ちゃくちゃく
茶碗	ちゃわん
	チャンス
	ちゃんと
中	ちゅう
注	ちゅう
中央	ちゅうおう
中学	ちゅうがく
中間	ちゅうかん
中古	ちゅうこ
中止	ちゅうし
駐車	ちゅうしゃ
中旬	ちゅうじゅん
抽象	ちゅうしょう
昼食	ちゅうしょく
中心	ちゅうしん
中世	ちゅうせい
中性	ちゅうせい
中途	ちゅうと
中年	ちゅうねん
注目	ちゅうもく
注文	ちゅうもん
超過	ちょうか
長期	ちょうき
彫刻	ちょうこく
調査	ちょうさ
調子	ちょうし
長所	ちょうしょ
長女	ちょうじょ
頂上	ちょうじょう
調整	ちょうせい
調節	ちょうせつ
	ちょうだい
長短	ちょうたん
頂点	ちょうてん
長男	ちょうなん
長方形	ちょうほうけい
調味料	ちょうみりょう
	チョーク
貯金	ちょきん
直後	ちょくご
直接	ちょくせつ
直線	ちょくせん
直前	ちょくぜん
直通	ちょくつう
直流	ちょくりゅう
著者	ちょしゃ
貯蔵	ちょぞう
直角	ちょっかく
直径	ちょっけい
散らかす	ちらかす
散らかる	ちらかる
散らす	ちらす
塵紙	ちりがみ
散る	ちる
遂に	ついに
追加	ついか
	ついで
通過	つうか
通貨	つうか
通学	つうがく
通勤	つうきん
通行	つうこう
通じる	つうじる
通ずる	つうずる
通信	つうしん
通知	つうち
通帳	つうちょう
通訳	つうやく
通用	つうよう
通路	つうろ
捕まる	つかまる
掴む	つかむ
疲れ	つかれ
月	つき
付き合い	つきあい
付合う	つきあう
突き当たり	つきあたり
突き当たる	つきあたる
次々	つぎつぎ
月日	つきひ
就く	つく
点く	つく
突く	つく
次ぐ	つぐ
注ぐ	つぐ
作る/造る	つくる
付ける	つける
着ける	つける
点ける	つける
浸ける	つける
伝わる	つたわる
土	つち
続き	つづき
突っ込む	つっこむ
包み	つつみ
勤め	つとめ
務め	つとめ
務める	つとめる
努める	つとめる
綱	つな
繋がり	つながり
繋がる	つながる
繋ぐ	つなぐ
繋げる	つなげる
常に	つねに
翼	つばさ
粒	つぶ
潰す	つぶす
潰れる	つぶれる
	つまずく
	つまり
詰まる	つまる
罪	つみ
積む	つむ
爪	つめ
詰める	つめる
積もる	つもる
艶	つや
梅雨	つゆ
強気	つよき
辛い	つらい
釣	つり
釣り合う	つりあう
吊る	つる
吊す	つるす
連れ	つれ
	で
出会い	であい
出合い	であい
出会う	であう
手洗い	てあらい
提案	ていあん
定員	ていいん
定価	ていか
低下	ていか
定期	ていき
定期券	ていきけん
定休日	ていきゅうび
抵抗	ていこう
停止	ていし
停車	ていしゃ
提出	ていしゅつ
停電	ていでん
程度	ていど
出入り	でいり
出入口	でいりぐち
停留所	ていりゅうじょ
手入れ	ていれ
	デート
	テーマ
出掛ける	でかける
敵	てき
出来上がり	できあがり
出来上がる	できあがる
的確	てきかく
適確	てきかく
出来事	できごと
適する	てきする
適切	てきせつ
適度	てきど
適用	てきよう
できる	（可能。出現。発生）
出来るだけ	できるだけ
	できれば
手首	てくび
凸凹	でこぼこ
手頃	てごろ
手品	てじな
	ですから
	でたらめ
手帳	てちょう
鉄	てつ
哲学	てつがく
鉄橋	てっきょう
手伝い	てつだい
手続き	てつづき
徹底	てってい
鉄道	てつどう
鉄砲	てっぽう
徹夜	てつや
	テニスコート
手拭い	てぬぐい
では	では
手間	てま
手前	てまえ
出迎え	でむかえ
出迎える	でむかえる
でも	でも
	デモ
照らす	てらす
照る	てる
展開	てんかい
伝記	でんき
電球	でんきゅう
典型	てんけい
天候	てんこう
電子	でんし
点数	てんすう
伝染	でんせん
電池	でんち
点々	てんてん
転々	てんてん
電柱	でんちゅう
	テント
伝統	でんとう
天然	てんねん
天皇	てんのう
電波	でんぱ
	テンポ
電流	でんりゅう
電力	でんりょく
度	ど
問い	とい
問い合わせ	といあわせ
党	とう
塔	とう
どう	（接。副）
銅	どう
答案	とうあん
統一	とういつ
同一	どういつ
	どうか
同格	どうかく
峠	とうげ
統計	とうけい
動作	どうさ
東西	とうざい
当時	とうじ
動詞	どうし
同時	どうじ
当日	とうじつ
	どうしても
投書	とうしょ
登場	とうじょう
	どうせ
	どうぞよろしく
灯台	とうだい
到着	とうちゃく
道徳	どうとく
盗難	とうなん
当番	とうばん
投票	とうひょう
等分	とうぶん
透明	とうめい
灯油	とうゆ
東洋	とうよう
同様	どうよう
同僚	どうりょう
道路	どうろ
童話	どうわ
十	とお
通す	とおす
通り	とおり
通り掛かる	とおりかかる
通り過ぎる	とおりすぎる
都会	とかい
溶かす	とかす
尖る	とがる
時	とき
	どきどき
溶く	とく
解く	とく
退く	どく
毒	どく
得意	とくい
特殊	とくしゅ
読書	どくしょ
特色	とくしょく
独身	どくしん
特徴	とくちょう
特長	とくちょう
特定	とくてい
独特	どくとく
特売	とくばい
独立	どくりつ
溶け込む	とけこむ
溶ける	とける
解ける	とける
退ける	どける
	どこか
床の間	とこのま
床屋	とこや
	ところが
	ところで
所々	ところどころ
登山	とざん
都市	とし
年月	としつき
図書	としょ
年寄	としより
閉じる	とじる
都心	としん
戸棚	とだな
途端	とたん
土地	とち
	とっくに
突然	とつぜん
	どっと
	トップ
届く	とどく
整う	ととのう
留まる	とどまる
	どなる
	とにかく
飛ばす	とばす
飛び込む	とびこむ
飛び出す	とびだす
跳ぶ	とぶ
留まる	とまる
留める	とめる
泊める	とめる
友	とも
	ともかく
共に	ともに
土曜	どよう
虎	とら
	ドライブ
捕える	とらえる
	トラック
	ドラマ
	トランプ
取り上げる	とりあげる
取り入れる	とりいれる
取り消す	とりけす
取り出す	とりだす
努力	どりょく
採る	とる
捕る	とる
どれ	どれ
	トレーニング
	ドレス
取れる	とれる
泥	どろ
とん	（1000
	とんでもない
	どんな
	どんなに
	トンネル
丼	どんぶり
名	な
内科	ないか
内線	ないせん
内容	ないよう
	ナイロン
	なお
治す	なおす
仲	なか
永い	ながい
流す	ながす
仲直り	なかなおり
	なかなか
半ば	なかば
長引く	ながびく
仲間	なかま
中身	なかみ
中味	なかみ
眺め	ながめ
眺める	ながめる
中指	なかゆび
仲良し	なかよし
流れ	ながれ
流れる	ながれる
慰める	なぐさめる
亡くす	なくす
	なぐる
無し	なし
為す	なす
	なぜなら
謎	なぞ
謎謎	なぞなぞ
傾らか	なだらか
懐かしい	なつかしい
納得	なっとく
撫でる	なでる
等	など
七	なな
斜め	ななめ
何	なに
何	なん
何か	なにか
	なにしろ
何々	なになに
何分	なにぶん
	なにも
鍋	なべ
生	なま
生意気	なまいき
怠ける	なまける
波	なみ
並木	なみき
涙	なみだ
悩む	なやむ
倣う	ならう
鳴らす	ならす
為る	なる
成る	なる
生る	なる
馴れる	なれる
縄	なわ
南極	なんきょく
何で	なんで
何でも	なんでも
何とか	なんとか
	なんとなく
	なんとも
	ナンバー
南米	なんべい
南北	なんぼく
似合う	にあう
煮える	にえる
匂い	におい
匂う	におう
逃がす	にがす
苦手	にがて
握る	にぎる
憎い	にくい
憎む	にくむ
憎らしい	にくらしい
	にこにこ
濁る	にごる
虹	にじ
日	にち
日時	にちじ
日常	にちじょう
日曜	にちよう
日用品	にちようひん
日課	にっか
日光	にっこう
日中	にっちゅう
	にっこり
日程	にってい
日本	にっぽん
日本	にほん
鈍い	にぶい
入院	にゅういん
入学	にゅうがく
入社	にゅうしゃ
入場	にゅうじょう
女房	にょうぼう
睨む	にらむ
煮る	にる
俄	にわか
人気	にんき
人間	にんげん
縫う	ぬう
抜く	ぬく
抜ける	ぬける
布	ぬの
濡らす	ぬらす
濡れる	ぬれる
ね	（感）
根	ね
値	ね
願い	ねがい
願う	ねがう
	ねじ
捩る	ねじる
鼠	ねずみ
値段	ねだん
	ネックレス
熱心	ねっしん
熱する	ねっする
熱帯	ねったい
熱中	ねっちゅう
寝間着	ねまき
寝巻	ねまき
狙い	ねらい
狙う	ねらう
年間	ねんかん
年月	ねんげつ
年中	ねんじゅう
年代	ねんだい
年度	ねんど
年齢	ねんれい
野	の
能	のう
農家	のうか
農業	のうぎょう
農産物	のうさんぶつ
農村	のうそん
濃度	のうど
農民	のうみん
農薬	のうやく
能率	のうりつ
能力	のうりょく
ノー	（no）
軒	のき
	のこぎり
残す	のこす
残らず	のこらず
残り	のこり
乗せる	のせる
載せる	のせる
覗く	のぞく
除く	のぞく
望み	のぞみ
望む	のぞむ
後	のち
	ノック
喉	のど
伸ばす	のばす
延ばす	のばす
伸びる	のびる
延びる	のびる
述べる	のべる
上り	のぼり
上る	のぼる
昇る	のぼる
糊	のり
乗換	のりかえ
載る	のる
鈍い	のろい
	のろのろ
呑気	のんき
	のんびり
場	ば
はあ	（感）
	パーセント
はい	（感）
灰	はい
灰色	はいいろ
梅雨	ばいう
	バイオリン
	ハイキング
俳句	はいく
拝見	はいけん
配達	はいたつ
売店	ばいてん
	バイバイ
売買	ばいばい
	パイプ
俳優	はいゆう
	パイロット
這う	はう
生える	はえる
墓	はか
馬鹿	ばか
剥す	はがす
博士	はかせ
	ばからしい
秤	はかり
計る	はかる
量る	はかる
測る	はかる
吐き気	はきけ
	はきはき
履く	はく
掃く	はく
吐く	はく
拍手	はくしゅ
莫大	ばくだい
爆発	ばくはつ
博物館	はくぶつかん
歯車	はぐるま
激しい	はげしい
	バケツ
挟まる	はさまる
	はさみ
挟む	はさむ
破産	はさん
端	はし
箸	はし
梯子	はしご
始まり	はじまり
始めに	はじめに
初めに	はじめに
	はじめまして
斜	はす
	パス
外す	はずす
	パスポート
外れる	はずれる
旗	はた
肌	はだ
	パターン
裸	はだか
肌着	はだぎ
畑	はたけ
果して	はたして
二十	はたち
働き	はたらき
鉢	はち
×	ばつ
発揮	はっき
	バック
	バッグ
発見	はっけん
発行	はっこう
発車	はっしゃ
発射	はっしゃ
罰する	ばっする
発想	はっそう
発達	はったつ
	ばったり
発展	はってん
発電	はつでん
発売	はつばい
発表	はっぴょう
発明	はつめい
派手	はで
話合い	はなしあい
話し合う	はなしあう
話し掛ける	はなしかける
話中	はなしちゅう
離す	はなす
放す	はなす
甚だしい	はなはだしい
花火	はなび
花嫁	はなよめ
離れる	はなれる
放れる	はなれる
羽	はね
羽根	はね
	ばね
跳ねる	はねる
幅	はば
母親	ははおや
省く	はぶく
破片	はへん
歯磨き	はみがき
	はめる
場面	ばめん
早口	はやくち
流行る	はやる
腹	はら
原	はら
払い込む	はらいこむ
払い戻す	はらいもどす
	バランス
針	はり
針金	はりがね
張り切る	はりきる
張る	はる
番	ばん
	バン
範囲	はんい
反映	はんえい
半径	はんけい
判子	はんこ
反抗	はんこう
犯罪	はんざい
万歳	ばんざい
	ハンサム
判事	はんじ
反省	はんせい
判断	はんだん
番地	ばんち
	パンツ
	バンド
半島	はんとう
	ハンドル
犯人	はんにん
販売	はんばい
灯	ひ
日当たり	ひあたり
	ビール
被害	ひがい
日帰り	ひがえり
比較	ひかく
比較的	ひかくてき
日陰	ひかげ
	ぴかぴか
引受る	ひきうける
引返す	ひきかえす
引算	ひきざん
引出す	ひきだす
引き止める	ひきとめる
卑怯	ひきょう
引分け	ひきわけ
轢く	ひく
	ピクニック
髭	ひげ
悲劇	ひげき
飛行	ひこう
膝	ひざ
陽射	ひざし
肘	ひじ
非常	ひじょう
美人	びじん
	ピストル
額	ひたい
	ビタミン
	ぴたり
引っ掛かる	ひっかかる
筆記	ひっき
	びっくり
引っ繰り返す	ひっくりかえす
引っ繰り返る	ひっくりかえる
日付	ひづけ
引越し	ひっこし
引っ込む	ひっこむ
必死	ひっし
筆者	ひっしゃ
必需品	ひつじゅひん
	ぴったり
引っ張る	ひっぱる
否定	ひてい
	ビデオ
一言	ひとこと
人込み	ひとごみ
人差指	ひとさしゆび
等しい	ひとしい
一通り	ひととおり
人通り	ひとどおり
	ひとまず
瞳	ひとみ
一休み	ひとやすみ
独り	ひとり
独り言	ひとりごと
	ひとりでに
一人一人	ひとりひとり
	ビニール
皮肉	ひにく
日日	ひにち
捻る	ひねる
日の入り	ひのいり
日の出	ひので
批判	ひはん
響き	ひびき
響く	ひびく
批評	ひひょう
皮膚	ひふ
秘密	ひみつ
微妙	びみょう
紐	ひも
冷やす	ひやす
	ひゃっかじてん
費用	ひよう
表	ひょう
美容	びよう
秒	びょう
評価	ひょうか
表現	ひょうげん
表紙	ひょうし
標識	ひょうしき
標準	ひょうじゅん
表情	ひょうじょう
平等	びょうどう
評判	ひょうばん
標本	ひょうほん
表面	ひょうめん
評論	ひょうろん
平仮名	ひらがな
	ビルディング
昼寝	ひるね
広がる	ひろがる
広げる	ひろげる
広さ	ひろさ
広場	ひろば
広々	ひろびろ
広める	ひろめる
品	ひん
瓶	びん
便	びん
	ピン
	ピンク
便箋	びんせん
瓶詰	びんづめ
不	ふ
不	ぶ
無	ぶ
分	ぶ
	ファスナー
不安	ふあん
風景	ふうけい
風船	ふうせん
夫婦	ふうふ
不運	ふうん
笛	ふえ
殖える	ふえる
不可	ふか
深まる	ふかまる
武器	ぶき
不規則	ふきそく
普及	ふきゅう
付近	ふきん
拭く	ふく
副詞	ふくし
複写	ふくしゃ
複数	ふくすう
服装	ふくそう
含む	ふくむ
含める	ふくめる
膨らます	ふくらます
膨らむ	ふくらむ
袋	ふくろ
不潔	ふけつ
更ける	ふける
不幸	ふこう
符号	ふごう
夫妻	ふさい
塞がる	ふさがる
塞ぐ	ふさぐ
	ふざける
無沙汰	ぶさた
節	ふし
武士	ぶし
無事	ぶじ
不思議	ふしぎ
部首	ぶしゅ
不自由	ふじゆう
夫人	ふじん
婦人	ふじん
襖	ふすま
不正	ふせい
防ぐ	ふせぐ
不足	ふそく
附属	ふぞく
蓋	ふた
舞台	ぶたい
双子	ふたご
再び	ふたたび
普段	ふだん
縁	ふち
打つ	ぶつ
不通	ふつう
物価	ぶっか
	ぶつかる
	ぶつける
物質	ぶっしつ
物騒	ぶっそう
	ぶつぶつ
物理	ぶつり
筆	ふで
ふと	（副）
船便	ふなびん
船	ふね
部品	ぶひん
吹雪	ふぶき
部分	ぶぶん
不平	ふへい
父母	ふぼ
不満	ふまん
踏切	ふみきり
麓	ふもと
増やす	ふやす
殖やす	ふやす
	フライパン
	ブラウス
	ぶらさげる
	ブラシ
	プラス
	プラスチック
	プラットホーム
	プラン
不利	ふり
	フリー
振り仮名	ふりがな
	プリント
振る	ふる
震える	ふるえる
振舞う	ふるまう
	ブレーキ
触れる	ふれる
風呂	ふろ
	プロ
	ブローチ
	プログラム
風呂敷	ふろしき
	ふわふわ
分	ぶん
文	ぶん
雰囲気	ふんいき
噴火	ふんか
分解	ぶんかい
文芸	ぶんげい
文献	ぶんけん
噴水	ふんすい
分数	ぶんすう
分析	ぶんせき
文体	ぶんたい
分布	ぶんぷ
文房具	ぶんぼうぐ
文脈	ぶんみゃく
文明	ぶんめい
分野	ぶんや
分量	ぶんりょう
分類	ぶんるい
塀	へい
閉会	へいかい
平気	へいき
平均	へいきん
並行	へいこう
平日	へいじつ
兵隊	へいたい
平凡	へいぼん
平野	へいや
平和	へいわ
凹む	へこむ
	へそ
隔てる	へだてる
別荘	べっそう
別に	べつに
別々	べつべつ
	ベテラン
減らす	へらす
	ヘリコプター
減る	へる
	へる
	ベルト
	ぺん
変化	へんか
	ペンキ
勉強	べんきょう
変更	へんこう
編集	へんしゅう
便所	べんじょ
	ペンチ
	ベンチ
弁当	べんとう
方	ほう
法	ほう
棒	ぼう
望遠鏡	ぼうえんきょう
方角	ほうがく
箒	ほうき
方言	ほうげん
冒険	ぼうけん
方向	ほうこう
報告	ほうこく
坊さん	ぼうさん
防止	ぼうし
方針	ほうしん
宝石	ほうせき
放送	ほうそう
包装	ほうそう
法則	ほうそく
包帯	ほうたい
膨大	ぼうだい
庖丁	ほうちょう
方程式	ほうていしき
防犯	ぼうはん
豊富	ほうふ
方法	ほうほう
方々	ほうぼう
方面	ほうめん
訪問	ほうもん
坊や	ぼうや
放る	ほうる
吠える	ほえる
	ボーイ
	ボート
	ボーナス
	ホーム
	ボール
他	ほか
外	ほか
朗らか	ほがらか
牧場	ぼくじょう
牧畜	ぼくちく
保健	ほけん
誇り	ほこり
埃	ほこり
募集	ぼしゅう
保証	ほしょう
干す	ほす
	ポスター
保存	ほぞん
北極	ほっきょく
坊っちゃん	ぼっちゃん
程	ほど
歩道	ほどう
	ほどく
仏	ほとけ
骨	ほね
炎	ほのお
頬	ほほ
頬	ほお
	ほぼ
微笑む	ほほえむ
褒める	ほめる
堀	ほり
濠	ほり
掘る	ほる
彫る	ほる
	ぼろ
盆	ぼん
盆地	ぼんち
本当	ほんと
本当	ほんとう
本人	ほんにん
本部	ほんぶ
本物	ほんもの
	ぼんやり
本来	ほんらい
間	ま
	まあ
	マーケット
	まあまあ
	マイク
迷子	まいご
枚数	まいすう
毎度	まいど
	マイナス
任せる	まかせる
巻く	まく
蒔く	まく
撒く	まく
幕	まく
枕	まくら
負け	まけ
曲げる	まげる
孫	まご
	まごまご
	まさか
摩擦	まさつ
	まさに
混ざる	まざる
交ざる	まざる
真面目	まじめ
混じる	まじる
交じる	まじる
増す	ます
先ず	まず
	マスク
貧しい	まずしい
	マスター
	ますます
混ぜる	まぜる
交ぜる	まぜる
又	また
未だ	まだ
	またぐ
又は	または
街	まち
待合室	まちあいしつ
待ち合わせる	まちあわせる
間違い	まちがい
街角	まちかど
松	まつ
真っ赤	まっか
真っ暗	まっくら
真っ黒	まっくろ
真っ青	まっさお
真っ先	まっさき
真っ白	まっしろ
真っ直ぐ	まっすぐ
全く	まったく
祭	まつり
祭る	まつる
窓口	まどぐち
纏まる	まとまる
纏める	まとめる
学ぶ	まなぶ
真似	まね
招く	まねく
真似る	まねる
	まぶしい
	まぶた
	マフラー
	ママ
豆	まめ
間も無く	まもなく
守る	まもる
	マラソン
丸	まる
円	まる
丸い	まるい
円い	まるい
	まるで
稀	まれ
回す	まわす
回り	まわり
回り道	まわりみち
万一	まんいち
満員	まんいん
	マンション
満足	まんぞく
満点	まんてん
身	み
実	み
見送り	みおくり
見送る	みおくる
見下ろす	みおろす
見掛け	みかけ
味方	みかた
三日月	みかづき
見事	みごと
岬	みさき
	みじめ
	ミシン
	ミス
店屋	みせや
見出し	みだし
道順	みちじゅん
満ちる	みちる
密	みつ
見付かる	みつかる
見付ける	みつける
	みっともない
認める	みとめる
皆	みんな
見直す	みなおす
見慣れる	みなれる
醜い	みにくい
実る	みのる
身分	みぶん
見本	みほん
見舞い	みまい
見舞う	みまう
未満	みまん
土産	みやげ
都	みやこ
妙	みょう
明後日	みょうごにち
名字	みょうじ
未来	みらい
ミリ	（メートル）
魅力	みりょく
見る	みる
診る	みる
	ミルク
民間	みんかん
民謡	みんよう
無	む
向かい	むかい
向う	むかう
迎え	むかえ
向く	むく
剥く	むく
向ける	むける
無限	むげん
無視	むし
無地	むじ
蒸し暑い	むしあつい
虫歯	むしば
矛盾	むじゅん
寧ろ	むしろ
蒸す	むす
無数	むすう
結ぶ	むすぶ
無駄	むだ
夢中	むちゅう
胸	むね
紫	むらさき
無料	むりょう
群れ	むれ
芽	め
姪	めい
明確	めいかく
名作	めいさく
名刺	めいし
名詞	めいし
名所	めいしょ
命じる	めいじる
命ずる	めいずる
迷信	めいしん
名人	めいじん
名物	めいぶつ
銘々	めいめい
命令	めいれい
迷惑	めいわく
目上	めうえ
	メーター
恵まれる	めぐまれる
巡る	めぐる
目指す	めざす
目覚し	めざまし
飯	めし
目下	めした
目印	めじるし
目立つ	めだつ
	めちゃくちゃ
	めっきり
滅多に	めったに
	めでたい
	メニュー
	めまい
	メモ
目安	めやす
面	めん
綿	めん
免許	めんきょ
免税	めんぜい
面積	めんせき
面接	めんせつ
面倒	めんどう
面倒臭い	めんどうくさい
	メンバー
儲かる	もうかる
儲ける	もうける
申し込む	もうしこむ
申し訳	もうしわけ
申し訳ない	もうしわけない
毛布	もうふ
燃える	もえる
	モーター
木材	もくざい
目次	もくじ
目的	もくてき
目標	もくひょう
木曜	もくよう
潜る	もぐる
文字	もじ
文字	もんじ
	もしかしたら
	もしかすると
	もしも
	もたれる
	モダン
餅	もち
持ち上げる	もちあげる
用いる	もちいる
勿論	もちろん
	もったいない
最も	もっとも
尤も	もっとも
	モデル
元	もと
基	もと
素	もと
戻す	もどす
基づく	もとづく
求める	もとめる
元々	もともと
者	もの
物置	ものおき
物音	ものおと
物語	ものがたり
物語る	ものがたる
物事	ものごと
物差し	ものさし
物凄い	ものすごい
	モノレール
紅葉	もみじ
揉む	もむ
燃やす	もやす
模様	もよう
催し	もよおし
貰う	もらう
盛る	もる
文句	もんく
問答	もんどう
	やがて
	やかましい
夜間	やかん
薬缶	やかん
役	やく
約	やく
訳	やく
役者	やくしゃ
役所	やくしょ
訳す	やくす
役人	やくにん
薬品	やくひん
役目	やくめ
役割	やくわり
火傷	やけど
夜行	やこう
矢印	やじるし
	やたらに
家賃	やちん
厄介	やっかい
薬局	やっきょく
	やっつける
宿	やど
雇う	やとう
家主	やぬし
屋根	やね
	やはり
	やっぱり
破く	やぶく
破る	やぶる
破れる	やぶれる
	やむをえない
辞める	やめる
	やや
軟らかい	やわらかい
唯一	ゆいいつ
遊園地	ゆうえんち
夕刊	ゆうかん
勇気	ゆうき
友好	ゆうこう
有効	ゆうこう
優秀	ゆうしゅう
優勝	ゆうしょう
友情	ゆうじょう
友人	ゆうじん
郵送	ゆうそう
夕立	ゆうだち
有能	ゆうのう
夕日	ゆうひ
郵便	ゆうびん
夕べ	ゆうべ
	ユーモア
悠々	ゆうゆう
有利	ゆうり
有料	ゆうりょう
床	ゆか
愉快	ゆかい
浴衣	ゆかた
湯気	ゆげ
輸血	ゆけつ
輸出	ゆしゅつ
譲る	ゆずる
輸送	ゆそう
豊か	ゆたか
油断	ゆだん
	ゆっくり
	ゆでる
輸入	ゆにゅう
湯飲み	ゆのみ
緩い	ゆるい
許す	ゆるす
夜	よ
夜明け	よあけ
様	よう
酔う	よう
容易	ようい
溶岩	ようがん
容器	ようき
陽気	ようき
要求	ようきゅう
用語	ようご
要旨	ようし
幼児	ようじ
用心	ようじん
様子	ようす
要するに	ようするに
容積	ようせき
要素	ようそ
幼稚	ようち
幼稚園	ようちえん
要点	ようてん
用途	ようと
曜日	ようび
洋品店	ようひんてん
養分	ようぶん
羊毛	ようもう
漸く	ようやく
要領	ようりょう
	ヨーロッパ
予期	よき
欲張り	よくばり
余計	よけい
横切る	よこぎる
	よこす
汚す	よごす
予算	よさん
止す	よす
寄せる	よせる
余所	よそ
予測	よそく
四つ角	よつかど
	ヨット
酔っ払い	よっぱらい
夜中	よなか
世の中	よのなか
予備	よび
呼び掛ける	よびかける
呼び出す	よびだす
余分	よぶん
予報	よほう
予防	よぼう
読み	よみ
蘇る	よみがえる
嫁	よめ
余裕	よゆう
	より
因る	よる
	よると
慶び	よろこび
喜び	よろこび
慶ぶ	よろこぶ
宜しい	よろしい
よろしく	（感）
四	よん
来	らい
	ライター
来日	らいにち
楽	らく
落第	らくだい
	ラケット
	ラッシュアワー
欄	らん
	ランチ
	ランニング
乱暴	らんぼう
利益	りえき
理科	りか
理解	りかい
利害	りがい
陸	りく
利口	りこう
離婚	りこん
	リズム
理想	りそう
率	りつ
	リットル
立派	りっぱ
	リボン
略す	りゃくす
流域	りゅういき
留学	りゅうがく
流行	りゅうこう
量	りょう
寮	りょう
両替	りょうがえ
両側	りょうがわ
料金	りょうきん
漁師	りょうし
領事	りょうじ
領収	りょうしゅう
臨時	りんじ
留守番	るすばん
例	れい
礼	れい
例外	れいがい
礼儀	れいぎ
冷静	れいせい
零点	れいてん
冷凍	れいとう
	レインコート
	レクリェーション
	レジャー
列	れつ
列車	れっしゃ
列島	れっとう
	レベル
	レポート
	リポート
煉瓦	れんが
連合	れんごう
練習	れんしゅう
	レンズ
連想	れんそう
連続	れんぞく
老人	ろうじん
蝋燭	ろうそく
労働	ろうどう
	ローマじ
録音	ろくおん
	ロケット
	ロッカー
	ロビー
論じる	ろんじる
論ずる	ろんずる
論争	ろんそう
論文	ろんぶん
輪	わ
	ワイン
和英	わえい
	わがまま
分る	わかる
別れ	わかれ
分かれる	わかれる
若々しい	わかわかしい
脇	わき
湧く	わく
分ける	わける
	わざと
僅か	わずか
綿	わた
話題	わだい
詫びる	わびる
和服	わふく
笑い	わらい
	わりあいに
割算	わりざん
割と	わりと
割引	わりびき
割る	わる
悪口	わるくち
我々	われわれ
湾	わん
椀	わん
碗	わん
	ワンピース
	あ
	ああ
	あいさつ・する
間	あいだ
合う	あう
	あかちゃん
上る	あがる
赤ん坊	あかんぼう
空く	あく
	アクセサリー
	あげる
浅い	あさい
味	あじ
	アジア
明日	あす
遊び	あそび
集る	あつまる
集める	あつめる
	アナウンサー
	アフリカ
	アメリカ
謝る	あやまる
	アルコール
	アルバイト
安心	あんしん
安全	あんぜん
	あんな
案内	あんない・する
以下	いか
以外	いがい
医学	いがく
生きる	いきる
意見	いけん
石	いし
	いじめる
以上	いじょう
急ぐ	いそぐ
致す	いたす
	いただく
一度	いちど
一生懸命	いっしょうけんめい
	いっぱい
糸	いと
以内	いない
田舎	いなか
祈る	いのる
	いらっしゃる
植える	うえる
	うかがう
受付	うけつけ
受ける	うける
動く	うごく
	うそ
	うち
打つ	うつ
美しい	うつくしい
写す	うつす
移る	うつる
腕	うで
	うまい
裏	うら
売り場	うりば
	うれしい
	うん
運転	うんてん・する
運転手	うんてんしゅ
運動	うんどう・する
	エスカレーター
枝	えだ
選ぶ	えらぶ
遠慮	えんりょ・する
	おいでになる
お祝い	おいわい
	オートバイ
	おかげ
	おかしい
億	おく
屋上	おくじょう
贈り物	おくりもの
送る	おくる
遅れる	おくれる
起す	おこす
行う	おこなう
怒る	おこる
押し入れ	おしいれ
お嬢さん	おじょうさん
お宅	おたく
落る	おちる
	おっしゃる
夫	おっと
	おつり
音	おと
落す	おとす
踊り	おどり
踊る	おどる
驚く	おどろく
お祭り	おまつり
お見舞い	おみまい
お土産	おみやげ
思い出す	おもいだす
思う	おもう
	おもちゃ
表	おもて
親	おや
下りる	おりる
折る	おる
お礼	おれい
折れる	おれる
終わり	おわり
	カーテン
海岸	かいがん
会議	かいぎ
会議室	かいぎしつ
会場	かいじょう
会話	かいわ
帰り	かえり
変える	かえる
科学	かがく
鏡	かがみ
掛ける	かける
飾る	かざる
火事	かじ
	ガス
	ガソリン
	ガソリンスタンド
堅/硬/固い	かたい
形	かたち
片付ける	かたづける
課長	かちょう
勝つ	かつ
	かっこう
家内	かない
悲しい	かなしい
必ず	かならず
お・金持ち	かねもち/おかねもち
彼女	かのじょ
壁	かべ
	かまう
髪	かみ
噛む	かむ
通う	かよう
	ガラス
彼	かれ
彼ら	かれら
乾く	かわく
代わり	かわり
変わる	かわる
考える	かんがえる
関係	かんけい
看護婦	かんごふ
簡単	かんたん
気	き
機会	きかい
危険	きけん
聞こえる	きこえる
汽車	きしゃ
技術	ぎじゅつ
季節	きせつ
規則	きそく
	きっと
絹	きぬ
厳しい	きびしい
気分	きぶん
決る	きまる
君	きみ
決める	きめる
気持ち	きもち
着物	きもの
客	きゃく
急	きゅう
急行	きゅうこう
教育	きょういく
教会	きょうかい
競争	きょうそう
興味	きょうみ
近所	きんじょ
具合	ぐあい
空気	くうき
空港	くうこう
草	くさ
	くださる
首	くび
雲	くも
比べる	くらべる
	くれる
暮れる	くれる
君	くん
毛	け
計画	けいかく・する
経験	けいけん・する
経済	けいざい
警察	けいさつ
	ケーキ
	けが・する
景色	けしき
消しゴム	けしゴム
下宿	げしゅく
決して	けっして
	けれど/けれども
原因	げんいん
	けんか・する
研究	けんきゅう
研究室	けんきゅうしつ
見物	けんぶつ
子	こ
	こう
郊外	こうがい
講義	こうぎ
工業	こうぎょう
高校	こうこう
高校生	こうこうせい
工場	こうじょう
校長	こうちょう
交通	こうつう
講堂	こうどう
高等学校	こうとうがっこう
公務員	こうむいん
国際	こくさい
心	こころ
御主人	ごしゅじん
故障	こしょう・する
ご存じ	ごぞんじ
答	こたえ
	ごちそう
	こと
小鳥	ことり
	このあいだ
	このごろ
細かい	こまかい
	ごみ
込む	こむ
米	こめ
	ごらんになる
	これから
怖い	こわい
壊す	こわす
壊れる	こわれる
	コンサート
今度	こんど
	コンピュータ/コンピューター
今夜	こんや
最近	さいきん
最後	さいご
最初	さいしょ
坂	さか
探す	さがす
下る	さがる
盛ん	さかん
下げる	さげる
差し上げる	さしあげる
	さっき
寂しい	さびしい
さ来月	さらいげつ
さ来週	さらいしゅう
	サラダ
騒ぐ	さわぐ
触る	さわる
産業	さんぎょう
	サンダル
	サンドイッチ
残念	ざんねん
市	し
字	じ
試合	しあい
仕方	しかた
	しかる
試験	しけん
事故	じこ
地震	じしん
時代	じだい
下着	したぎ
支度	したく・する
	しっかり
失敗	しっぱい
辞典	じてん
品物	しなもの
	しばらく
島	しま
市民	しみん
事務所	じむしょ
社会	しゃかい
社長	しゃちょう
	じゃま
	ジャム
自由	じゆう
習慣	しゅうかん
住所	じゅうしょ
柔道	じゅうどう
十分	じゅうぶん
出席	しゅっせき・する
出発	しゅっぱつ・する
趣味	しゅみ
準備	じゅんび・する
紹介	しょうかい
小学校	しょうがっこう
小説	しょうせつ
招待	しょうたい・する
承知	しょうち・する
将来	しょうらい
食事	しょくじ・する
食料品	しょくりょうひん
女性	じょせい
知らせる	しらせる
調べる	しらべる
人口	じんこう
神社	じんじゃ
親切	しんせつ
心配	しんぱい・する
新聞社	しんぶんしゃ
水泳	すいえい
水道	すいどう
	ずいぶん
数学	すうがく
	スーツ
	スーツケース
過ぎる	すぎる
	すく
	スクリーン
凄い	すごい
進む	すすむ
	すっかり
	すっと
	ステーキ
捨てる	すてる
	ステレオ
砂	すな
	すばらしい
滑る	すべる
隅	すみ
済む	すむ
	すり
	すると
生活	せいかつ・する
生産	せいさん・する
政治	せいじ
西洋	せいよう
世界	せかい
席	せき
説明	せつめい
背中	せなか
	ぜひ
世話	せわ・する
線	せん
	ぜんぜん
戦争	せんそう
先輩	せんぱい
	そう
相談	そうだん・する
育てる	そだてる
卒業	そつぎょう
祖父	そふ
	ソフト
祖母	そぼ
	それで
	それに
	それほど
	そろそろ
	そんな
	そんなに
退院	たいいん・する
大学生	だいがくせい
大事	だいじ
大体	だいたい
	たいてい
	タイプ
大分	だいぶ
台風	たいふう
倒れる	たおれる
	だから
確か	たしか
足す	たす
訪ねる	たずねる
尋ねる	たずねる
正しい	ただしい
畳	たたみ
立てる	たてる
建てる	たてる
例えば	たとえば
棚	たな
楽しみ	たのしみ
楽む	たのしむ
	たまに
為	ため
	だめ
足りる	たりる
男性	だんせい
暖房	だんぼう
血	ち
	チェック・する
力	ちから
	ちっとも
	ちゃん
注意	ちゅうい
中学校	ちゅうがっこう
注射	ちゅうしゃ
駐車場	ちゅうしゃじょう
地理	ちり
捕まえる	つかまえる
	つき
付く	つく
漬ける	つける
都合	つごう
伝える	つたえる
続く	つづく
続ける	つづける
包む	つつむ
妻	つま
	つもり
釣る	つる
連れる	つれる
丁寧	ていねい
	テキスト
適当	てきとう
	できるだけ
手伝う	てつだう
	テニス
手袋	てぶくろ
寺	てら
点	てん
店員	てんいん
天気予報	てんきよほう
電灯	でんとう
電報	でんぽう
展覧会	てんらんかい
都	と
道具	どうぐ
	とうとう
動物園	どうぶつえん
遠く	とおく
通る	とおる
特に	とくに
特別	とくべつ
	とこや
途中	とちゅう
特急	とっきゅう
届ける	とどける
泊まる	とまる
止める	とめる
取り替える	とりかえる
泥棒	どろぼう
	どんどん
直す	なおす
直る	なおる
治る	なおる
中々	なかなか
泣く	なく
無くなる	なくなる
亡くなる	なくなる
投げる	なげる
	なさる
鳴る	なる
	なるべく
	なるほど
慣れる	なれる
	におい
苦い	にがい
二階建て	にかいだて
逃げる	にげる
日記	にっき
入院	にゅういん・する
入学	にゅうがく・する
似る	にる
人形	にんぎょう
盗む	ぬすむ
塗る	ぬる
	ぬれる
	ねだん
熱	ねつ
	ねっしん
寝坊	ねぼう
眠い	ねむい
眠る	ねむる
残る	のこる
	のど
乗り換える	のりかえる
乗り物	のりもの
葉	は
場合	ばあい
	パート
倍	ばい
拝見	はいけん・する
歯医者	はいしゃ
運ぶ	はこぶ
始める	はじめる
場所	ばしょ
	はず
恥ずかしい	はずかしい
	パソコン
発音	はつおん
	はっきり
花見	はなみ
林	はやし
払う	はらう
番組	ばんぐみ
反対	はんたい
	ハンドバッグ
日	ひ
火	ひ
	ピアノ
冷える	ひえる
光	ひかり
光る	ひかる
引き出し	ひきだし
引き出す	ひきだす
	ひげ
飛行場	ひこうじょう
久しぶり	ひさしぶり
美術館	びじゅつかん
非常に	ひじょうに
	びっくり・する
引っ越す	ひっこす
必要	ひつよう
	ひどい
開く	ひらく
	ビル
昼間	ひるま
昼休み	ひるやすみ
拾う	ひろう
	ファックス
増える	ふえる
深い	ふかい
複雑	ふくざつ
復習	ふくしゅう
部長	ぶちょう
普通	ふつう
	ぶどう
太る	ふとる
布団	ふとん
舟	ふね
不便	ふべん
踏む	ふむ
降り出す	ふりだす
	プレゼント
文化	ぶんか
文学	ぶんがく
文法	ぶんぽう
別	べつ
	ベル
変	へん
返事	へんじ
貿易	ぼうえき
放送	ほうそう・する
法律	ほうりつ
僕	ぼく
星	ほし
	ほど
	ほとんど
	ほめる
翻訳	ほんやく
参る	まいる
負ける	まける
	まじめ
	まず
	または
間違える	まちがえる
間に合う	まにあう
周り	まわり
回る	まわる
漫画	まんが
真中	まんなか
見える	みえる
湖	みずうみ
味噌	みそ
見つかる	みつかる
見つける	みつける
皆	みな
港	みなと
向かう	むかう
迎える	むかえる
昔	むかし
虫	むし
息子	むすこ
娘	むすめ
無理	むり
召し上がる	めしあがる
珍しい	めずらしい
申し上げる	もうしあげる
申す	もうす
	もうすぐ
	もし
	もちろん
	もっとも
戻る	もどる
木綿	もめん
	もらう
森	もり
焼く	やく
約束	やくそく
役に立つ	やくにたつ
焼ける	やける
優しい	やさしい
痩せる	やせる
	やっと
	やはり/やっぱり
止む	やむ
止める	やめる
柔らかい	やわらかい
湯	ゆ
輸出	ゆしゅつ・する
輸入	ゆにゅう・する
指	ゆび
指輪	ゆびわ
夢	ゆめ
揺れる	ゆれる
用	よう
用意	ようい
用事	ようじ
汚れる	よごれる
予習	よしゅう
予定	よてい
予約	よやく
寄る	よる
喜ぶ	よろこぶ
	よろしい
理由	りゆう
利用	りよう
両方	りょうほう
旅館	りょかん
留守	るす
冷房	れいぼう
歴史	れきし
	レジ
	レポート/リポート
連絡	れんらく
	ワープロ
沸かす	わかす
別れる	わかれる
沸く	わく
訳	わけ
忘れ物	わすれもの
笑う	わらう
割合	わりあい
割れる	われる
泳ぎ方	およぎかた
会う	あう
青	あお
青い	あおい
赤	あか
赤い	あかい
明い	あかるい
秋	あき
開く	あく
開ける	あける
上げる	あげる
朝	あさ
朝御飯	あさごはん
	あさって
足	あし
明日	あした
	あそこ
遊ぶ	あそぶ
暖かい	あたたかい
頭	あたま
新しい	あたらしい
	あちら
暑い	あつい
熱い	あつい
厚い	あつい
	あっち
後	あと
	あなた
兄	あに
姉	あね
	あの
	あの
	アパート
	あびる
危ない	あぶない
甘い	あまい
	あまり
雨	あめ
飴	あめ
洗う	あらう
	ある
歩く	あるく
	あれ
	いい/よい
	いいえ
言う	いう
家	いえ
	いかが
行く	いく
	いくつ
	いくら
池	いけ
医者	いしゃ
	いす
忙しい	いそがしい
痛い	いたい
一	いち
一日	いちにち
	いちばん
	いつ
五日	いつか
一緒	いっしょ
五つ	いつつ
	いつも
犬	いぬ
今	いま
意味	いみ
妹	いもうと
嫌	いや
入口	いりぐち
居る	いる
要る	いる
入れる	いれる
色	いろ
	いろいろ
上	うえ
後ろ	うしろ
薄い	うすい
歌	うた
歌う	うたう
生まれる	うまれる
海	うみ
売る	うる
煩い	うるさい
上着	うわぎ
絵	え
映画	えいが
映画館	えいがかん
英語	えいご
	ええ
駅	えき
	エレベーター
鉛筆	えんぴつ
	おいしい
多い	おおい
大きい	おおきい
大きな	おおきな
大勢	おおぜい
お母さん	おかあさん
お菓子	おかし
お金	おかね
起きる	おきる
置く	おく
奥さん	おくさん
お酒	おさけ
お皿	おさら
伯父/叔父	おじいさん
教える	おしえる
伯父/叔父	おじさん
押す	おす
遅い	おそい
お茶	おちゃ
お手洗い	おてあらい
お父さん	おとうさん
弟	おとうと
男	おとこ
男の子	おとこのこ
一昨日	おととい
一昨年	おととし
大人	おとな
	おなか
同じ	おなじ
お兄さん	おにいさん
お姉さん	おねえさん
	おばあさん
伯母さん/叔母さん	おばさん
お風呂	おふろ
お弁当	おべんとう
覚える	おぼえる
	おまわりさん
重い	おもい
	おもしろい
泳ぐ	およぐ
降りる	おりる
終る	おわる
音楽	おんがく
女	おんな
女の子	おんなのこ
外国	がいこく
外国人	がいこくじん
会社	かいしゃ
階段	かいだん
買い物	かいもの
買う	かう
返す	かえす
帰る	かえる
	かかる
	かぎ
書く	かく
学生	がくせい
	かける
傘	かさ
貸す	かす
風	かぜ
風邪	かぜ
家族	かぞく
方	かた
学校	がっこう
	カップ
家庭	かてい
角	かど
	かばん
花瓶	かびん
紙	かみ
	カメラ
火曜日	かようび
辛い	からい
体	からだ
借りる	かりる
軽い	かるい
	カレー
	カレンダー
川/河	かわ
	かわいい
漢字	かんじ
木	き
黄色	きいろ
黄色い	きいろい
消える	きえる
聞く	きく
北	きた
	ギター
汚い	きたない
喫茶店	きっさてん
切手	きって
切符	きっぷ
昨日	きのう
九	きゅう / く
牛肉	ぎゅうにく
牛乳	ぎゅうにゅう
今日	きょう
教室	きょうしつ
兄弟	きょうだい
去年	きょねん
嫌い	きらい
切る	きる
着る	きる
	きれい
	キロ/キログラム
	キロ/キロメートル
銀行	ぎんこう
金曜日	きんようび
薬	くすり
	ください
果物	くだもの
口	くち
靴	くつ
靴下	くつした
国	くに
曇り	くもり
曇る	くもる
暗い	くらい
	クラス
	グラム
来る	くる
車	くるま
黒	くろ
黒い	くろい
警官	けいかん
今朝	けさ
消す	けす
結構	けっこう
結婚	けっこん
月曜日	げつようび
玄関	げんかん
元気	げんき
五	ご
公園	こうえん
交差点	こうさてん
紅茶	こうちゃ
交番	こうばん
声	こえ
	コート
	コーヒー
	ここ
午後	ごご
九日	ここのか
九つ	ここのつ
午前	ごぜん
答える	こたえる
	こちら
	こっち
	コップ
今年	ことし
言葉	ことば
子供	こども
	この
御飯	ごはん
	コピーする
困る	こまる
	これ
今月	こんげつ
今週	こんしゅう
	こんな
今晩	こんばん
	さあ
財布	さいふ
魚	さかな
先	さき
咲く	さく
作文	さくぶん
差す	さす
雑誌	ざっし
砂糖	さとう
寒い	さむい
さ来年	さらいねん
三	さん
散歩	さんぽする
四	し / よん
塩	しお
	しかし
時間	じかん
仕事	しごと
辞書	じしょ
静か	しずか
下	した
七	しち / なな
質問	しつもん
自転車	じてんしゃ
自動車	じどうしゃ
死ぬ	しぬ
字引	じびき
自分	じぶん
閉まる	しまる
閉める	しめる
締める	しめる
	じゃ/じゃあ
写真	しゃしん
	シャツ
	シャワー
十	じゅう とお
授業	じゅぎょう
宿題	しゅくだい
上手	じょうず
丈夫	じょうぶ
	しょうゆ
食堂	しょくどう
知る	しる
白	しろ
白い	しろい
新聞	しんぶん
水曜日	すいようび
吸う	すう
	スカート
好き	すき
少ない	すくない
	すぐに
少し	すこし
涼しい	すずしい
	ストーブ
	スプーン
	スポーツ
	ズボン
住む	すむ
	スリッパ
	する
座る	すわる
背	せ
生徒	せいと
	セーター
	せっけん
背広	せびろ
狭い	せまい
	ゼロ
千	せん
先月	せんげつ
先週	せんしゅう
先生	せんせい
洗濯	せんたく
全部	ぜんぶ
掃除	そうじする
	そうして/そして
	そこ
	そちら
	そっち
外	そと
	その
	そば
空	そら
	それ
	それから
	それでは
大学	だいがく
大使館	たいしかん
大丈夫	だいじょうぶ
大好き	だいすき
大切	たいせつ
台所	だいどころ
	たいへん
	たいへん
高い	たかい
	たくさん
	タクシー
出す	だす
立つ	たつ
	たて
建物	たてもの
楽しい	たのしい
頼む	たのむ
	たばこ
	たぶん
食べ物	たべもの
食べる	たべる
卵	たまご
誰	だれ
誰	だれか
誕生日	たんじょうび
	だんだん
小さい	ちいさい
小さな	ちいさな
近い	ちかい
違う	ちがう
近く	ちかく
地下鉄	ちかてつ
地図	ちず
茶色	ちゃいろ
	ちゃわん
	ちょうど
	ちょっと
一日	ついたち
使う	つかう
疲れる	つかれる
次	つぎ
着く	つく
机	つくえ
作る	つくる
	つける
勤める	つとめる
	つまらない
冷たい	つめたい
強い	つよい
手	て
	テープ
	テーブル
	テープレコーダー
出かける	でかける
手紙	てがみ
	できる
出口	でぐち
	テスト
	では
	デパート
	でも
出る	でる
	テレビ
天気	てんき
電気	でんき
電車	でんしゃ
電話	でんわ
戸	と
	ドア
	トイレ
	どう
	どうして
	どうぞ
動物	どうぶつ
	どうも
遠い	とおい
十日	とおか
時々	ときどき
時計	とけい
	どこ
所	ところ
年	とし
図書館	としょかん
	どちら
	どっち
	とても
	どなた
隣	となり
	どの
飛ぶ	とぶ
止まる	とまる
友達	ともだち
土曜日	どようび
鳥	とり
とり肉	とりにく
取る	とる
撮る	とる
	どれ
	ナイフ
中	なか
長い	ながい
鳴く	なく
無くす	なくす
	なぜ
夏	なつ
夏休み	なつやすみ
	など
七つ	ななつ
七日	なのか
名前	なまえ
習う	ならう
並ぶ	ならぶ
並べる	ならべる
	なる
何	なん/なに
二	に
賑やか	にぎやか
肉	にく
西	にし
日曜日	にちようび
荷物	にもつ
	ニュース
庭	にわ
脱ぐ	ぬぐ
温い	ぬるい
	ネクタイ
猫	ねこ
寝る	ねる
	ノート
登る	のぼる
飲み物	のみもの
飲む	のむ
乗る	のる
歯	は
	パーティー
	はい
灰皿	はいざら
入る	はいる
葉書	はがき
	はく
箱	はこ
橋	はし
	はし
始まる	はじまる
初め/始め	はじめ
初めて	はじめて
走る	はしる
	バス
	バター
二十歳	はたち
働く	はたらく
八	はち
二十日	はつか
花	はな
鼻	はな
話	はなし
話す	はなす
早い	はやい
速い	はやい
春	はる
貼る	はる
晴れ	はれ
晴れる	はれる
半	はん
晩	ばん
	パン
	ハンカチ
番号	ばんごう
晩御飯	ばんごはん
半分	はんぶん
東	ひがし
引く	ひく
弾く	ひく
低い	ひくい
飛行機	ひこうき
左	ひだり
人	ひと
一つ	ひとつ
一月	ひとつき
一人	ひとり
暇	ひま
百	ひゃく
病院	びょういん
病気	びょうき
昼	ひる
昼御飯	ひるごはん
広い	ひろい
	フィルム
封筒	ふうとう
	プール
	フォーク
吹く	ふく
服	ふく
二つ	ふたつ
豚肉	ぶたにく
二人	ふたり
二日	ふつか
太い	ふとい
冬	ふゆ
降る	ふる
古い	ふるい
	ふろ
文章	ぶんしょう
	ページ
下手	へた
	ベッド
	ペット
部屋	へや
辺	へん
	ペン
勉強	べんきょうする
便利	べんり
帽子	ぼうし
	ボールペン
	ほか
	ポケット
欲しい	ほしい
	ポスト
細い	ほそい
	ボタン
	ホテル
本	ほん
本棚	ほんだな
	ほんとう
毎朝	まいあさ
毎月	まいげつ/まいつき
毎週	まいしゅう
毎日	まいにち
毎年	まいねん/まいとし
毎晩	まいばん
前	まえ
曲る	まがる
	まずい
	また
	まだ
町	まち
待つ	まつ
	まっすぐ
	マッチ
窓	まど
丸い/円い	まるい
万	まん
万年筆	まんねんひつ
磨く	みがく
右	みぎ
短い	みじかい
水	みず
店	みせ
見せる	みせる
道	みち
三日	みっか
三つ	みっつ
緑	みどり
皆さん	みなさん
南	みなみ
耳	みみ
見る 観る	みる
	みんな
六日	むいか
向こう	むこう
難しい	むずかしい
六つ	むっつ
村	むら
目	め
	メートル
眼鏡	めがね
	もう
もう一度	もういちど
木曜日	もくようび
持つ	もつ
	もっと
物	もの
門	もん
問題	もんだい
八百屋	やおや
野菜	やさい
易しい	やさしい
安い	やすい
休み	やすみ
休む	やすむ
八つ	やっつ
山	やま
	やる
夕方	ゆうがた
夕飯	ゆうはん
郵便局	ゆうびんきょく
昨夜	ゆうべ
有名	ゆうめい
雪	ゆき
行く	ゆく
	ゆっくりと
八日	ようか
洋服	ようふく
	よく
横	よこ
四日	よっか
四つ	よっつ
呼ぶ	よぶ
読む	よむ
夜	よる
弱い	よわい
来月	らいげつ
来週	らいしゅう
来年	らいねん
	ラジオ
	ラジカセ / ラジオカセット
	りっぱ
留学生	りゅうがくせい
両親	りょうしん
料理	りょうり
旅行	りょこう
零	れい
冷蔵庫	れいぞうこ
	レコード
	レストラン
練習	れんしゅうする
廊下	ろうか
六	ろく
	ワイシャツ
若い	わかい
分かる	わかる
忘れる	わすれる
私	わたくし
私	わたし
渡す	わたす
渡る	わたる
悪い	わるい
	より、ほう

